%%%%%%%%%%%%%%%%%%%%%%%%%%%%%%%%%%%%%%%%%%%%%%%%%%%%%%%%%%%%%%%%%%%%%%%%%%%%%%%%%%%%%%%%%%%%%%%%%%%%%
%           %%%             %%%%%%%%%%%%%     %%% %%%%% %%%%%       %%%%%%%         %%%%%%%%%       %
%%%%% % %%% %%%%% %%%%% %%%%%%%%%%%%%%%%% % %%%%% %%%%% %%%%% %%%%% %%%%%%%%%%% %%% %%%%%%%%%%%%% %%%
%%%%% % %   %%%%%   %%% %%%%%%% %%%%% %%% % %%%%% %%%   %%%   %%% %       %%%%% %     %%%%% %%%   %%%
%%%%%%% %%%%%%%%%%% %%%%%%%%%%% %%%%% %%% %%%%%%% %%% % %%% %%%%% %%% %%% %%%%% % %%% %%%%% %%% % %%%
%%%%%%% %%%%%%%     %%%%%         %%%     %%%%%   %   %   %         % %   %     % %%% %%%   %   %   %
%%%%%%% %%%%%%% %%% %%%%% %%%%%%% %%%%% %%%%%%%%% % % %%%%% %%%%% %%% % %%% %%%%% %%%%%%% % % %%% %%%
%%%%%%%   %%%%%   % %%%     % %%% %%%   %%%%%%%%%   % %%%   %%%%% %%% % %   % %%%   %%%   %   %%% %%%
%%%%%%% % %%%%%%% % %%%%%%% % %%% %%% %%%%%%%%%%%%% % %%% %%%%%%%%%%% % %%% % %%% % %%%%% %%%%%%% %%%
%%%%%   %     %%% %   %%%     %%%     %%% %%%   %%% %           %%%   %   %   %%% %   %%% % %%%     %
%%%%%%% %%%%% %%% %%%%%%% %%%%%%%%%%% %%% %%% % %%% %%%%% %%%%% %%%%% %%% %%%%%%% %%% %%% % %%% %%%%%
%   %%%   %%%     %%%%% % %%%%%%% %     %     % %%%   %%% %%%%%   %%%   % %   %%% %%%     %   %   %%%
% %%%%%%% %%%%% %%%%%%% % %%%%%%% % %%% % %%%%% %%%%%%%%% %%%%% %%%%%%% % % % %%%%%%%%% %%% %%%%% %%%
%         %%%   %%%%%       % %%% % %%% %     %   %%%%%     %%% %%%     %   %       %%% %%% %%%     %
% %%% % %%%%% %%%%%%%%%%%%% % %%% % %%%%% %%% %%% %%%%%%%%%%%%%%%%%%% %%%%% %%%%% %%%%% %%% %%% %%% %
% %%% %   % %       %%%%%   %     %     % %%%   %     %%%       %     %%%   %%% % %%%%%   %   % %%% %
%%%%%%%%% % %%%%%%% %%%%% %%%%%%% %%%%% % %%%%%%%%%%% %%% %%%%% % %%%%%%%%%%%%% % %%%%%%% %%% % %%%%%
%%%%%%%%% %             %           %%%   %%%%%           %   % % %%%%% %%%%%         %%% %   % %%%%%
%%%%%%%%% %%% %%%%%%%%%%%%%%%%%%%%% %%%%%%%%%%% %%%%%%%%%%%%% % % %%%%% %%%%%%%%%%%%% %%% % %%% %%%%%
% %%%     %%%   %%%   %%% %   %%%%%     %%%     % %     %%%%%     % %       %%%%%   %     %     %   %
% %%% %%%%%%% %%%%% % %%% % % %%%%%%%%% %%%%% %%% % % %%%%%%%%%%%%% % %%% % %%%%%%% % %%%%%%%%% % % %
%     %%%%%   %%%%% %       %         % %%%%%   %   %   %%% %%%%%%%   %   %   %%%%%   %%% %%%%%   % %
% %%%%%%%%% %%%%%%% %%%%%%%%%%% %%% % % %%%%%%% %%%%%%% %%% %%%%%%% %%% % %%% %%%%%%% %%% %%%%%%%%% %
%       %   %%%     %%%     %%% %%% %   %%% %%%   %%%%%       %%%   %%% % %%%   %%%%% %%%   %%%%%%% %
%%% %%% %%% %%% %%%%%%% %%% %%%%%%%%%%%%%%% %%%%% %%%%%%%%%%% %%% %%%%% %%%%%%%%%%%%%%%%% %%%%%%%%% %
%%% %%%   % % %   %%%     %   %%%%%%% %%%!  %%%%%     %%%%%%%         %     %%%%% %%%%% %           %
%%% %%%%% % % %%% %%% %%%%% % %%%%%%% %%% %%%%%%% % % %%%%%%%%%%%%%%% %%% % %%%%% %%%%% % %%%%%%%%% %
%     %   % %   %   % %%%%% %             %%%     % %   %%%   %%%%%%% %%% %               %%%%%%%%% %
%%% %%% %%% % % %%% %%%%%%% %%%%% %%%%% % %%% %%%%% % %%%%% % %%%%%%% %%%%%%%%%%%%%%%%%%%%%%%%%%%%%%%
%%% %   %%%   % %%% %%% %%%   %%%   %   % %%% %%%%% % %%%   %     %%% % %%%     %%%%% %%%%% %%%   %%%
%%% % %%%%%%% %%%%% %%% %%%%% %%%%%%% %%%%%%%%%%%%% %%%%% %%%%% % %%% % %%%%%%% %%%%% %%%%% %%% %%%%%
%   %       % %   %   %   %%%   %%%%% %%%%%%%%%     %%%%% %%%%% % %%% %     %   %%%%%           %%%%%
% %%% %%%%% % % % %%% % % %%%%% %%%%% %%%%%%%%%%%%% %%%%% %%%%% % %%% %%% % % % %%%%%%%%%%% % %%%%%%%
% %%% %%%%% % % %   % % % %%%%% %%%   %%%%%%%%%     %%%   %%%   % %%%     %   %   %%%%%%%   % %%%%%%%
% %%%%%%%%% % % %%% % % % %%%%% %%%%% %%%%%%%%% % %%%%%%% %%% %%%%%%%%%%%%%%%%%%% %%%%%%% %%% %%%%%%%
% %%%%%     % %   % %   %   %   %%%     %%% %   % %   %%%   %       %   %%% %%%   %%%     %%%   %%%%%
%%%%%%% %%%%%%%%% % %%%%%%% %%%%%%% % %%%%% % %%%%% % %%%%% %%% %%% % % %%% %%% %%%%% %%% %%%%% %%%%%
%%%%%   %%%%%%%%% %       % %       % %%%%% %     % %       %%% %   % %       %   %%% %%% %         %
%%%%%%% %%%%%%%%% %%% %%%%% % %%%%%%% %%%%% %%%%% % %%% %%%%%%%%% % %%%%% % %%%%% %%%%%%% %%% %%%%% %
%%%%%     %%%   % %%%         %%%%%           %%%   %%%   %%%     % %%%%% % %%%%% %%%     %%% %%%%% %
%%%%% %%%%%%% % % %%%%%%%%% %%%%%%% %%%%%%%%%%%%%%%%%%%%% %%% %%%%%%%%%%% %%%%%%% %%% %%%%%%%%%%%%% %
%%%%%         % % %     %%% %%% %%%   %%%%%%%%%   %%% %%% %%% %   %%%%%           %   %%%   %%%     %
%%%%% %%%%% % %%% % %%%%%%%%%%% %%%%% %%%%%%%%%%% %%% %%%%%%% % % %%%%%%%%% %%% %%%%% %%% % %%% %%%%%
%%%   %%%%% % %%% %   %%% %%%     %%%   %   %%%         %%%     %     %%%%% %%%       %   % %%%     %
%%%%% %%%%%%% %%% % % %%% %%% % %%%%%%% %%% %%% %%% %%%%%%%%% %%%%%%% %%%%%%%%%%%%%%% %%%%% %%%%%%% %
%%%%% %%%%%%%     % %         % %%%   %     %   %   %%%%%%%%%   % %%%   %%%%% %   %%% %%%%%         %
%%%%% %%%%%%% %%% %%%%%%%%% %%%%%%% %%%%%%% %%% %%% %%%%%%%%%%% % %%% %%%%%%% % % %%% %%%%% %%%%%%%%%
%     %%%%%%% %%% %%%       %%%%%%% %       %   %%%   %%%   %%% %   %   %%%   % %   %   %%%   %%%%%%%
% %%%%%%%%%%%%%%% %%% %%%%% %%%%%%% % %%%%%%% %%%%%%% %%% % %%% % % %%% %%% %%% %%% % %%%%%%% %%%%%%%
% %   %%%%%%%%% % %%% %%%   %%%%%%% % %%%     %%%%%   %%% %   % % % %   %%%     %   % %%%%%%%       %
% % %%%%%%%%%%% % %%% %%%%%%%%%%%%% % %%%%% % %%%%% %%%%% % %%% % %%% %%%%%%% %%% %%%%%%%%%%%%%%% %%%
%   %%% %%%%%           %%%%% %%%%%   %     % %%%     %%% %     % %%%     %%%   %   %%%%%   %%%   %%%
%%% %%% %%%%%%% %%%%%%% %%%%% %%%%% %%%%% %%% %%%%% %%%%% %%%%%%% %%%%% % %%%%% %%% %%%%% % %%%%%%%%%
%         % %%% %%%%%   %     %%%     %%%   %   %%% %%%   %   %%% %%%%% %       %%%       %   %%%%%%%
% %%%%%%% % %%%%%%%%%%% %%% %%%%% %%% %%%%% % %%%%%%%%%%% % % %%% %%%%%%%%%%%%%%%%% %%%%% %%%%%%%%%%%
% %%%   %   %%%%%   %%% %%% %%%%% %%%       % %%%%%%%%%%%   %         %%%     %   %   %%%   %%%%%%%%%
%%%%% %%% %%%%%%% %%%%% %%% %%%%% %%%%%%%%%%% %%%%%%%%%%%%%%% %%%%%%% %%% %%% % % %%%%%%%%% %%%%%%%%%
%%%   %   %%%     %%%         %%% %%%%%         %%%   %%%   % %%%%% % %   %%%   % %%%%%%%%% %%%%%%%%%
%%%%% % %%%%%%% %%%%% %%%%%%%%%%%%%%%%%%%%% %%%%%%% % %%% % % %%%%% % % %%%%%%%%% %%%%%%%%% %%%%%%%%%
%%%%% %   %%%%% %%%%% %               %%%%% %%%     %     % % %%%%%   %     %%%%% %%%%%%%%%     %%%%%
%%%%% % %%%%%%% %%%%%%% %%%%%%%%%%%%% %%%%%%%%% % %%%%%%%%% %%%%%%% %%%%%%% %%%%% %%%%%%%%%%%%% %%%%%
%%%%% % %%%         %   %%%       %%%     %%%   % %%%%%%%   %%% %%% %%%%%%% %     % %%%   %%%   %%%%%
%%%%% % %%% %%%%%%% % %%%%% %%%%% %%%%%%% %%% % %%%%%%%%% %%%%% %%% %%%%%%% %%% %%% %%%%% %%% %%%%%%%
%   %   %   %%%%%%% %       %     %   %%% %%% %   % %     %%%   %%% %   %   %%%         %     %%%%%%%
%%% % %%% % %%%%%%%%%%%%%%%%% %%%%% % %%% %%%%% % % % %%%%%%%%% %%% % % % %%%%%%%%%%%%% % %%%%%%%%%%%
%%% %     % %%%%% %%%     %%% %%%   %         % % %         %%% %%% % % %     %%%     %   %   %%%%%%%
%%% %%%%% %%%%%%% %%%%%%% %%% %%%%%%%%%%%%%%% % % %%%%%%%%% %%% %%% % %%%%%%% %%% % %%%%% % % %%%%%%%
%   %     %%%     %     % %%% %           %%% % % %%%%%     %%%     % %%%     %   % %     % % %%%%% %
% %%% %%% %%% %%% %%% % % %%% % %%%%% %%% %%% %%% %%%%% %%% %%%%%%% % %%% % %%% % %%% %%%%% % %%%%% %
%     %%% %   %%%     % %   %   %%%%% %   %%%   %   %   %%%       % % %%% % %%% %       % % % %%%   %
%%%%%%%%% %%% %%%%%%%%% % % %%% %%%%%%% %%%%%%% %%% % %%%%%%%%%%% % % %%% %%%%%%%%%%%%% % % % %%% %%%
%%%%%%%%%     % %%%%% %   % %%%     %%% %   %%% %   % %%%         %     % %%%   %%%%%%%   % %     %%%
%%%%%%%%%%%%%%% %%%%% %%% %%%%% %%%%%%% %%% %%% % % %%%%% %%%%%%%%%%%%% % %%% % %%%%%%%%%%% %%%%% %%%
% %%%   %%%           %%% %%%%% %%%%%%% %%%   %   % %%% %     %%% %%%%% % %%% %           % %%% % % %
% %%% %%%%%%%%%%%%% %%%%% %%%%% %%%%%%% %%% % %%%%%%%%% %%%%% %%% %%%%%%% %%% %%%%%%% %%% % %%% % % %
%                   %%%   %%%%% %%%%%     % % %%%%%%%%%       %       %%% %%%     %%% %%%   %%%   % %
% %%% % %%%%%%%%%%% %%% %%%%%%%%%%%%%%%%% % %%%%%%%%%%%%% %%%%% %%%%% %%% %%%%%%% %%%%%%%%%%%%% %%% %
% %%% %     %%%     %%% %%%%%%%%%     %%% % %%%%%%%   %%%     % %%%         % %%%   %%%S%%%%%%%     %
%%%%% %%% % %%%%%%%%%%% %%%%%%%%%%% % %%% % %%%%%%% %%%%% %%% % %%% %%% %%% % %%% %%%%% %%%%%%% %%% %
%%%   %%% %             %   %%%   % %     %   %           %%%   %%% %%% %%%     %       %   %%% %%% %
%%%%%%%%%%%%% %%%%%%%%%%% % %%% % % %%%%%%% %%% %%% %%%%%%%%%%%%%%% %%%%%%%%%%% %%%%% %%% %%%%% %%%%%
%%%%%%%%%%%%% %%%         % %%% %   %%%         %%% %%%     %%%%%   % %%%%%     %%%%% %%%         %%%
%%%%%%%%%%%%% %%%%%%%%%%% %%%%% %%%%%%%%%%% %%%%%%% %%% % %%%%%%% %%% %%%%% %%% %%%%%%%%% %%% %%%%%%%
%%%%%%%%%     % %%%%%%%%% %%%         %%%%% %%%%%   %   % %%% %%%   % %%%   %%%     %%%   %%%   %%% %
%%%%%%%%%%% %%% %%%%%%%%% %%% %%%%%%% %%%%% %%%%% %%%%% % %%% %%%%% % %%% %%%%%%% %%%%% %%%%%%%%%%% %
%%%%%%%%%%% %%%   %%%     %%% %%%%%%% %%%   %%%     %%% % %%%   %     %%% %%%%%%% %%%   %%%%%%%%%   %
%%%%%%%%%%% %%% %%%%% %%% %%%%%%%%%%% %%%%%%%%%%%%% %%%%% %%% % % %%%%%%% %%%%%%%%%%% %%%%%%%%%%% % %
%%%%%%%%%%% %   %%%     % %%%%%   %%% %   %%% %%%%%     % %%% %   %%%%%%%   %%%%%%% %     %%% %%% % %
%%%%%%%%%%% %%% %%%%%%% %%%%%%% % %%% % % %%% %%%%%%%%% % %%%%% %%%%%%%%%%% %%%%%%% % %%% %%% %%%%% %
%%%%%%%       %   %%%%% %%%%%   %   %   % %     %%%   %   %%%%%   %%%%% %%%   %   %   %%%       %%% %
%%%%%%%%%%%%% % %%%%%%% %%%%% % %%%%%%%%% % %%% %%%%% % %%%%%%%%% %%%%% %%%%%%% % % %%%%% %%% %%%%% %
%%%%%%%%%%%%%   %%%     %   % %         %   %%%   %%%   %%%%%%%   %%%     %%%%% %   %%% % %%% %%%%% %
%%%%%%%%%%%%% %%%%% %%% % % % %%%%% %%% %%%%%%% % %%% %%%%%%%%%%%%%%% %%% %%%%% %%%%%%% % %%%%%%%%% %
% %%%%%%%%%%% %%%   %%%   %   %%%%%   % %%%%%   % %%%   %   %       %   %         %%%%%   %%%%%%%%% %
% %%%%%%%%%%% %%%%% %%% %%%%% %%%%% %%% %%%%%%% % %%% %%% % % %%%%% % %%% %%% %%% %%%%%%% %%%%%%%%% %
%   %%%%%%%   %%%%% %%%   %%%   %%% %   % %%%%% %   % %%% % %   % %   %%% %%% %%% %%%%%%%     %%%   %
% % %%%%%%% %%%%%%%%%%%%%%%%%%%%%%%%% % % %%%%%%% % %%%%% % %%% % %%%%%%%%%%%%%%%%%%%%%%%%%%% %%%%% %
% %   %%%   %%%%%       %%%         % %       %%% %       % %   % %%%%%%%%%%%%%%%%%%%%%     % %     %
% %%% %%% %%%%%%% % %%% %%% %%% %%% % %%% %%%%%%%%% %%% %%% % %%% %%%%%%%%%%%%%%%%%%%%% %%%%% %%% %%%
%   %             % %%%     %   %%%   %%% %%%%%%%%% %%% %%%       %%%%%%%%%%%%%%%%%%%%%           %%%
%%%%%%%%%%%%%%%%%%%%%%%%%%%%%%%%%%%%%%%%%%%%%%%%%%%%%%%%%%%%%%%%%%%%%%%%%%%%%%%%%%%%%%%%%%%%%%%%%%%%%
