%%%%%%%%%%%%%%%%%%%%%%%%%%%%%%%%%%%%%%%%%%%%%%%%%%%%%%%%%%%%%%%%%%%%%%%%%%%%%%%%%%%%%%%%%%%%%%%%%%%%%
% %%%%%%%%%   %%%     %%% %%%     %     %%%%%%%%%     %%%%%%%%%%%           %%%%%   %         %%%   %
% %%%%%%%%%%% %%% %%%%%%% %%% %%%%% %%% %%%%%%%%% % %%%%%%%%%%%%%%% %%% %%%%%%%%% % %%% %%%%%%%%%%% %
% %%%%%%%%%%% %%%   %%%   %%%         %   %%%%%%% % %%% %%%%%%%%%%% %   %%%%% %%% % %   %%%%%%%     %
% %%%%%%%%%%% %%%%% %%%%% %%% %%%%%%%%%%% %%%%%%% % %%% %%%%%%%%%%%%% %%%%%%% %%% % % %%%%%%%%% %%% %
% %%%%%%%%%%%   %%%       %%%       %%%     %%%%% %     %%%%%%%   %%%         %   %   %%%%%%%   %   %
% %%%%%%%%%%%%% %%% % %%%%%%%%% %%%%%%% %%%%%%%%% %%% %%%%%%%%% %%%%% %%%%% % % %%%%%%%%%%%%% %%%%%%%
%   %%%%%%% %%% %%% % %%%%% %%% %%%%%     %%%%%   %%% %%%%%%%   %%%%% %     %   %%%%%%%%%     %%%%%%%
% % %%%%%%% %%% %%% % %%%%% %%% %%%%%%%%% %%%%% % %%%%%%%%%%% %%%%%%% % %%% %%%%%%%%%%%%% %%% %%%%%%%
% % %%%%%   %%%     % %%%     % %%% %%%%%   %%% %   %%%%%%%   %       %   % %%%%%%%%%%%%% %%%       %
%%% %%%%%%% %%%%% %%%%%%% %%%%% %%% %%%%% % %%% % %%%%%%%%% %%% %%%%%%%%% % %%%%%%%%%%%%% %%% %%%%%%%
%%%           %%%                   %%%   % %%% % %%%       %   %     %%% %   %%%%%         %   %%%%%
%%%%%%% %%% %%%%%%%%%%% %%%%%%%%%%%%%%% %%% %%% % %%% %%% %%% %%%%% % %%% %%%%%%%%% %%%%%%% %%% %%%%%
%%%%%   %%% %%%%%%%%%%%!    %%%%%%%%%   % % %%% % %   %%% %%% %%%%% % %%% %   %%%%%   %   %   %     %
%%%%% %%%%%%%%%%%%%%%%% %%%%%%%%%%%%% %%% % %%%%% % %%%%% %%% %%%%% %%%%% % % %%%%%%% % % %%%%% %%% %
%%%   %%%%%%%%%%%%%%%%% %%%%%%%%%%%   %   %       %     % %   %%%   %%%   % %     %%% % % %     %%% %
%%% %%%%%%%%%%%%%%%%%%%%%%%%%%%%%%% %%% %%% %%%%%%%%% %%% % %%%%% % %%%%% % % %%% %%%%% % % %%%%%%%%%
%     %%%%%     %%%   %%%%%%%%%%% % %   %%% %%%%%%%%% %%%   %%%   %   %%%   % %%% %     % %   %%% %%%
% %%% %%%%% % %%%%% %%%%%%%%%%%%% % % % %%% %%%%%%%%% %%%%%%%%% % %%% %%%%%%% %%% % %%%%% %%% %%% %%%
% %   %     % %%%     %%%%%%%     %   %   %       %%% %%%   %   % %%%       % %%%   %     %%%     %%%
%%% % % %%% % %%%%% % %%%%%%%%%%% %%%%% %%%%%%%%% %%% %%% % % %%% %%%%% %%% % %%% %%% %%%%%%% %%%%%%%
%%% % % %%% % %%%%% %   %%% %%%%%       %%%   %%%         %   % %   %%% %%% % %   %%%   %     %%%%%%%
%%% % %%%%% %%%%%%%%% %%%%% %%%%% %%%%%%%%% %%%%%%% %%%%%%%%%%% % %%%%%%%%% % %%%%%%%%% % % %%%%%%%%%
%   %   %     %%%%%%% %     %     % %%%%%   %%%%%%% %%%%%%%%%     %%%     % % %%%%%%%%%   % %%%%%%%%%
% %%%%% % %%% %%%%%%% % %%% % %%%%% %%%%% % %%%%%%%%%%%%%%%%% %%% %%% %%% %%% %%%%%%%%%%%%%%%%%%%%%%%
% %%%%% % %%%     %%%   %%%   %%%%% %%%   %   %%%%%%%%%%%%%%% %%%   % %           %%% %%%%%%%%%%%%%%%
% %%%%% %%%%% %%%%%%%%%%%%% %%%%%%% %%%%% % % %%%%%%%%%%%%%%%%%%%%%%% %%%%% %%%%% %%% %%%%%%%%%%%%%%%
%   %     %%%       %%%%%       %%%     % % %   %%% %%%%%%%%%%%       %%%%% %%%%%     %     %%%%%%% %
%%% %%%%% %%%%%%% % %%%%%%% %%%%%%%%% % %%% %%% %%% %%%%%%%%%%% %%%%%%%%%%% %%%%%%%%% % %%%%%%%%%%% %
%%%   %%%         %     %%% %%%%%%%   %     %%% %%%     %%%%%%% %%% %%%   %   %%%     % %%%%%%%%%   %
%%%%% %%%%% %%%%%%%%%%% %%% %%%%%%% % %%%%% %%%%%%% %%%%%%%%%%% %%% %%% %%% %%%%%%% %%% %%%%%%%%% %%%
%%%%% %%%%% %%%   %%%   %   %       % %%%%% %%%%%%%     %       %           %%%%%%% %%%       %%%   %
%%%%% %%%%% %%%%% %%% %%% %%%%%%% %%% %%%%%%%%%%%%%%%%% % %%%%% %%% %%%%% %%%%%%%%% %%%%%%%%% %%%%% %
%%%   %%%     %%%     %     %     %       %%%         %   %%%   %%% %%%%% %%%%%%%   %     %%%       %
%%%%% %%%%% %%%%% %%% %%%%% % %%% %%% %%%%%%%%% %%%%% %%%%%%% %%%%%%%%%%%%%%%%%%% %%%%% % %%% %%%%% %
%%%%%     % %%%   %%% %%%     %   %%% %%%%%     %%%%%   %%%%% %%% %%%%% %%%%%   %       %   % % %%% %
%%%%%%%%% %%%%% %%%%% %%%%%%%%% %%%%% %%%%%%% %%%%%%%%% %%%%% %%% %%%%% %%%%%%% %%%%%%%%%%% % % %%% %
%%%       %%%%% %%%%%   %%%       %%% %   %%% %%%   %%%   %%%             %%%%%     %     % % %     %
%%% %%%%%%%%%%%%%%%%%%% %%%%%%%%%%%%% % % %%% %%% % %%% %%%%%%%%% % %%%%%%%%%%%%% % % % %%% % % %%% %
%%%   %     %   %   %%%   %%%%%%%%%     % %%% %   % %%% %%%%%%%%% % %%%%%%% %%%%% %   % %%%   % %%% %
%%% % % %%% % % % %%%%%%% %%%%%%%%% %%%%% %%% %%%%% %%% %%%%%%%%%%% %%%%%%% %%%%% %%%%%%%%%%%%% %%% %
%%% %     %   % % %%%   % %   %%%   %%%   %   %%%     % %%% %%%     %%%                   %     %%% %
%%% %%%%%%% %%% % %%%%% % %%% %%%%%%%%%%%%% %%%%% %%% % %%% %%% %%% %%% %%%%%%%%%%%%% %%% % %%% %%%%%
%%%     %%% %%% %       % %%% %%%%%%%%%%%   %%%     % %   %     %%% %%%   %%%%%     %   %   %%%   %%%
%%%%%%% %%%%%%% %%%%% %%% %%% %%%%%%%%%%% %%%%% %%% %%%%% % %%%%%%% %%%%%%%%%%% %%% %%% %%%%%%% %%%%%
%   %%%   %%% %     %   %   % %%% %%%     % %%% %%%       % %       %%%%%%%     %   % % %%%%%   %%% %
% % %%%%% %%% %%%%% % % %%% % %%% %%%%% %%% %%% %%%%%%%%% % % %%%%% %%%%%%%%% %%% %%% % %%%%% %%%%% %
% % %         %%%%% % %       %%%       %%%         %%%%%   % %%%%%       %%% %%% %     %%%   %%%%% %
% %%% %%%%%%% %%%%% %%% %%% %%%%% %%%%% %%%%%%%%%%% %%%%%%%%% %%%%%%%%%%% %%% %%% %%% %%%%%%% %%%%% %
%     %   %%%     %   % %%% %%%   %%%     %%%%%%%     %%%       %%%%%%%     %   % %%%     %S%       %
% %%%%%%% %%%%%%% %%% %%%%% %%%%% %%% %%%%%%%%%%% %%%%%%%%%%%%%%%%%%%%%%%%%%% %%% %%%%%%% % %%%%%%%%%
% %%%%%%%   %%%%% %%% %%% %       %%%   %%%   %%%   %%% %%%%%%%%%     %%%%%%% %%% %       % %%%%%%%%%
% %%%%%%%%% %%%%% %%% %%% % %%% %%%%% %%%%% %%%%%%%%%%% %%%%%%%%%%% % %%%%%%% %%% %%%%% %%% %%%%%%%%%
%       %%% %%%%%   % %     %%% %%%   %%%%%             %%%     %%% % %%%       %     % %%%   %%% %%%
%%%%%%% %%% %%%%%%%%% %%%%%%%%%%%%%%%%%%%%% %%% %%% %%% %%%%% %%%%% %%%%% %%%%%%%%%%% % %%% %%%%% %%%
%%% %%%     %%%%%%%   %%%%%%% %%% %%%%%     %%%   % %%%   %%% %%%%% %%%   % %%%%% %%% % % % %%%     %
%%% %%%%% %%%%%%%%% % %%%%%%% %%% %%%%% %%%%%%% %%% %%%%%%%%% %%%%% %%% %%% %%%%% %%% % % % %%%%% %%%
%         %%%     % % %%% %%%     %%%     %%% % %%%   %%%%%%%       %%% %%% %%%   %%% %   %   %%% %%%
% %%% %%% %%%%% %%% % %%% %%% % %%%%% %%%%%%% % %%%%% %%%%%%%%% %%%%%%% %%% %%% % %%% %%%%%%% %%% %%%
% %%% %%%   %%% %%% % %   %%% % %%% %   %%%       %%%     %%%%% %%%%%%% %       % %%% %%%%%%% %%%   %
%%%%% %%%%%%%%% %%% %%% % %%% % %%% % %%%%%%%%%%% %%%%% % %%%%% %%%%%%% % % %%%%% %%% %%%%%%% %%% %%%
%%%%%   %%%%%%% %%%     % %   %       %%%%%%%%%%%   %%% %         %%%%% % % %%%   %%%         %%% %%%
%%%%%%% %%%%%%% %%%%%%%%% % %%%%%%% %%%%%%%%%%%%%%% %%%%% %%%%%%% %%%%% % %%%%% %%%%%%%%%%%%%%%%% %%%
% %%%%% %     %       %%%       %%% %%%%%%%     %%% %%%%% %%%%%%%   %%%   %%% % %         %%%     %%%
% %%%%% % %%% % % %%%%%%%%%%%%% %%%%%%%%%%% %%% %%%%%%%%% %%%%%%%%% %%%%%%%%% % % %%% %%%%%%% % %%%%%
%       % %%%   %   %%%%%   %%% %%%%%%%%%   %%%   %%%%%%% %%%%%%%     %%%%%%% % % %   %%%%%%% %   %%%
% %%%%%%%%%%% %%%%% %%%%% % %%%%%%%%%%%%%%% %%%%% %%%%%%% %%%%%%%%%%% %%%%%%% % %%% % %%%%%%% %%% %%%
% % %%%%%%% % %%%%%   %%% %   %%%%% %%% %%%   %     %%% %       %%%%%   %%%     %%% %   %%%     %   %
% % %%%%%%% % %%%%% %%%%%%% %%%%%%% %%% %%%%% % %%%%%%% %%% %%%%%%%%% %%%%% %%%%%%% %%% %%%%%%%%%%% %
% %       %     %%%     %%% %%%%%         %%% %           % %     %%% %%% %       % %%%   %%%%%%%%% %
% % %%%%% % %%% %%%%% %%%%% %%%%%%% %%%%% %%% %%%%%%% %%% % % %%% %%% %%% %%%%%%% % %%%%%%%%%%%%%%% %
%   %   % % %%% %%%%%       %   %%% %%% % %%% %%%%%%% %   %     % %%% %           % %       %%%%%%% %
%%%%%%% % %%%%%%%%%%%%%%%%% % % %%% %%% % %%% %%%%%%% %%% %%%%%%% %%%%% %%%%%%%%%%% % %%% %%%%%%%%% %
%   %%% %   % %%%%%%%%%%%%% % %     %%% %   % % %%%   %%% %%%%%%%   %   %%% %%%%%%%   %%%     %%%   %
% %%%%% %%% % %%%%%%%%%%%%% % %%%%%%%%% %%% % % %%% %%%%%%%%%%%%%%% % %%%%% %%%%%%% %%%%% % %%%%% % %
% %%%     %   % %%%%%%% %     % %%%%%   %%%     %%%       %%%%%%%%%   %%%       %%% %   % % %%%   % %
% %%% %%%%%%% % %%%%%%% % %%%%% %%%%% %%%%%%%%%%%%%%% %%% %%%%%%%%%%%%%%%%% %%% %%% % % %%% %%% %%% %
%     %%%     %   %%% %   %         % %%%%%%% %%%%%%% %%%   %%%%%%%     %%% %%% %%% % % %%% %%% %%% %
%%%%% %%% %%%%%%% %%% % %%%%% % %%% % %%%%%%% %%%%%%% %%%%% %%%%%%%%% %%%%% %%% %%% % % %%% %%% %%% %
%%%%%     %%% %%%   %     %%% % %%%   %%%%%%%   %%%   %     %%%   %%% %%%   %%%     % %         %   %
%%%%%%% %%%%% %%% %%% %%%%%%%%% %%% %%%%%%%%% %%%%% %%% %%% %%% %%%%% %%%%%%%%% %%%%% %%%%%%%%% %%%%%
%   %%%       %%% %%%   %%%%%%% %   %%%       %%%   %   %%%     %%%     %%%%%%% %   %     %%%%% %%%%%
% % %%%%%%% %%%%% %%%%% %%%%%%% %%%%%%%%% %%% %%%%% % %%%%%%% %%%%%%%%% %%%%%%%%% % % %%% %%%%% %%%%%
% %         %%%   %       %%%%% %%%%%   % %%%   %%% %   %%%   %%%%%%%%% %%%%%     % % %%% %     %%%%%
% %%%%%%% %%%%% % % %%%%%%%%%%% %%%%% % %%%%%%% %%%%%%% %%%%%%%%%%%%%%% %%%%%%% %%% %%%%% % %%%%%%%%%
%   %%%%% %%%   %   %%% %%% %%%       % %%%       %%%%%   %%%%%     %%% %%%%%%%   %   %   %     % %%%
%%% %%%%% %%% %%% %%%%% %%% %%% % %%%%% %%%%% % %%%%%%% % %%%%% %%% %%% %%%%%%%%% %%% % %%%%%%% % %%%
%   %%%   %%% %%%   %%% %%%     % % %%%       % %%%     %   %   %   %           % %     %     % %   %
% %%%%%%% %%%%%%%%% %%% %%% %%% % % %%% %%%%%%%%%%% %%% %%% %%% % %%%%%%%%% %%% % %%%%%%%%%%% % %%% %
%   %%%%% %%%%% %%% %     % %%% % %     %%%%%%%%%%%   % %   %%% % %%%       %%%   %%%         %   % %
%%%%%%%%% %%%%% %%% % %%% %%%%%%% %%%%%%%%%%%%%%%%%%% % % %%%%% % %%% %%%%%%%%% %%%%% %%% %%%%%%% % %
%%%%% %   %           %%%   %%%   %%%%%%%%%%%         % %   %   %     %%%%%%%   %%%   %%% %%%%%%% % %
%%%%% % %%%%%%% %%%%%%%%%%% %%% %%%%%%%%%%%%% %%% %%%%% %%% % %%% %%%%%%%%%%% %%%%%%% %%%%%%%%%%% % %
% %%%         % %         %     %%%%%%%%%%%%% %%% %%%   %%%   %%% %%%   %     %%%%%%%       %%%%%   %
% %%% %%%%%%% %%% %%% %%% %%%%% %%%%%%%%%%%%% %%%%%%% %%%%%%% %%%%%%% %%% %%%%%%%%%%%%%%% % %%%%%%% %
%     %%%%%   %%%   % %%% %%%%% %   % %%%   % %%%%%   %%%%%%%   %%%%%   %   %%%     %%%%% %   %%%%% %
% %%% %%%%% %%%%% % %%%%% %%%%% % % % %%% % %%%%%%%%% %%%%%%%%% %%%%% % %%% %%% %%% %%%%% %%% %%%%% %
% %%% %%%     %%% % %%%     %   % %     % %           %%%%%%%%% %%%   % %       % %   %%%   %       %
%%%%%%%%% %%% %%%%% %%% %%% %%%%% %%%%% % %%%%% %%%%% %%%%%%%%%%%%%%%%% % %%%%%%% % %%%%%%% %%%%% %%%
%%%%%%%   %%%       %   %%%       %%%     %%%   %%%%%   %%%%%%%%%%%%%%%   %%%       %%%%%%%   %%%   %
%%%%%%%%%%%%%%%%%%%%%%%%%%%%%%%%%%%%%%%%%%%%%%%%%%%%%%%%%%%%%%%%%%%%%%%%%%%%%%%%%%%%%%%%%%%%%%%%%%%%%
