%%%%%%%%%%%%%%%%%%%%%%%%%%%%%%%%%%%%%%%%%%%%%%%%%%%%%%%%%%%%%%%%%%%%%%%%%%%%%%%%%%%%%%%%%%%%%%%%%%%%%
%%%%%%%%%%%%%%%%%%%%%%%     %%%%%           %%%   %%%     %%% %%%%%   %%%     %     %%%       %%%%% %
%%%%%%%%%%%%%%%%%%%%%%%%%%% %%%%%%% %%%%% %%%%% % %%%%% % %%% %%%%% %%%%% %%% %%%%% %%%%% % % %%%%% %
%%%%%%%%%%%%%%%%%%%%% %%%       %%%     % %%%   % %%%%% % %%%       %%%%% %           %%% % % %%%   %
%%%%%%%%%%%%%%%%%%%%% %%% %%% %%%%% %%%%% %%% % %%%%%%% %%%%% %%% %%%%%%% %%%%%%%%%%% %%% % %%%%% % %
%%%%%%%%%%%%%%%   %       %   %%%%% %%%       % %%%%%     %%% %%%     %%%     %%%     %   % %%%   % %
%%%%%%%%%%%%%%% % % %%% %%%%% %%%%%%%%% %%%%%%% %%%%%%%%% %%%%%%%%% %%%%% %%% %%%%% %%% %%% %%% %%% %
%%%%%%%%%%%%%%% %   %%% %%%%%   %%%%%       %   %%%%%%%%% %%%%%%%%%     % % %     % %%%   %     %   %
%%%%%%%%%%%%%%% %%%%%%% %%%%%%% %%%%%%% %%% %%%%%%%%%%%%% %%%%%%%%% % %%% % %%% % %%%%%%% %%%%%%% % %
%%%%%%%%%%%%% %   %%% % %%%%%%%     %%% %%% %%%%%%%             %%% %       %%% %             %%% % %
%%%%%%%%%%%%% %%% %%% % %%%%%%%%%%% %%% %%% %%%%%%%%% %%% %%% %%%%% %%%%%%%%%%% %%% %%%%%%% %%%%% %%%
%   %%% %%%%% %%% %%% % %%%     %%% %%% %%%   %%%%%%% %%% %%% %%%%%     %%%%%%% %%% %%%%%   %   % %%%
%%% %%% %%%%% %%% %%% % %%%%%%% %%% %%% %%%%% %%%%%%%%%%% %%%%%%%%%%%%% %%%%%%% %%% %%%%% %%% % % %%%
%%%                   % %%%%%%% %%% %%% %%%%%     %         %%%   %%%     %%%   %%% % %%%   % %   %%%
%%% %%%%%%%%%%%%%%%%%%% %%%%%%% %%% %%% %%%%% %%% % %%%%% %%%%% %%%%% %%%%%%% %%%%% % %%%%%%% %%% %%%
%%% %%%%%       %   %   % %     %   %%%     % %     %%%%% %       %%% %%%%%%% %%%       %     %%%   %
%%%%%%%%% %%%%% % % % %%% % %%% % %%%%% %%%%% %%%%%%%%%%%%% %%%%% %%%%%%%%%%%%%%%%%%%%%%% %%%%%%%%% %
%         % %%%   %   %     %%%   %%%   %%%%% %%%%%         %%%%%   %%%%%     %   %       %%%       %
%%% %%%%%%% %%%%%%%%% %%%%% %%% %%%%%%% %%%%% %%%%% %%%%%%%%%%%%%%% %%%%% %%% % % % % %%%%%%% %%%%%%%
%   %     %   %%%%%%% %%%%% %%%   % %%% %%%     %   %%%%%     %   %       %%%   %   % %%%%%   % %%%%%
% %%% %%% % % %%%%%%%%%%%%%%%%%%% % %%% %%% %%% % %%%%%%% %%% % % %%%%%%% %%%%%%%%%%%%%%%%% %%% %%%%%
%   % %%% % % %%%   %%%%%%%%%     %     %%% %   %   %%%   %%%   %   %%%%%   %%%%%   %%% %   %%%   %%%
% % % %%% %%% %%% % %%%%%%%%%%% %%% %%% %%%%% %%%%% %%%%% %%%%% %%% %%%%% %%%%%%%%% %%% % %%%%%%% %%%
% %   %%% %%%     % %%%%%%%%%%% %%% %%%   %%%   %   %%%   %     %%%   %%%   %%%%%   %%%   %%%       %
%%% %%%%% %%%%% % %%%%%%%%%%%%% %%%%%%%%%%%%% % % %%%%% %%%%% %%%%%%%%%%% % %%%%% %%%%% %%%%% % %%%%%
%%% %%%   %%%%% %       %%%%%   %%%%%   %%%   %       % %%%%%     %%%   % % % %%%     % %%%   % %%%%%
%%%%%%% % %%%%%%%%% %%% %%%%% %%%%%%% % %%%%% %%% %%% % %%%%%%%%%%%%% % %%% % %%%%%%% % %%%%% % %%%%%
% %%% % % %%%   %%% % %     %         %   %%% %%% %%% %     %%%%%%%%% %     %         % %     %     %
% %%% % % %%% % %%% % %%%%% %%%%%%%%%%% %%%%% %%%%%%% % %%% %%%%%%%%% %%%%%%% %%%%% %%% % %%%%%%%%% %
%       %     % %       %%%   %%%%%%%   %%%   %%%%%   % %%% %%%   %   %%%     %%%%% %%% % %%%%%   % %
%%% %%% %%%%%%% % %%%%%%%%% %%%%%%%%% %%%%% %%%%%%%%% %%%%% %%%%% % % %%% % %%%%%%% %%% % %%%%%%% % %
%%% %%%     %%% %   %%%%%   %%% %       %%% %%%   %%% %%%     %%%   % %%% % %%%     %%%   %%% %%%   %
%%%%%%%%%%% %%% %%% %%%%% % %%% % %%%%%%%%% %%%%% %%% %%% %%% %%% %%% %%% % %%%%%%%%%%%%%%%%% %%% %%%
% %%% %%%   %%% %   %%%%% %       %%%%%%%     %%%         %%% %%% %   %   %         %   %%%%%   % % %
% %%% %%%%%%%%% % %%%%%%%%%%%%%%%%%%%%%%% %%% %%%%% %%%%%%%%%%%%%%% %%%%%%% %%%%% % % % %%%%%%% % % %
% %%%   %%%%%   % %%%%%%%%% %%%%%     %%% %%%   %%%   %%%%%%%       %%%%%%% %%%%% %   %     %%% %   %
% %%% % %%%%% %%% %%%%%%%%% %%%%% %%% %%%%%%%%% %%% %%%%%%%%% % %%%%%%%%%%%%%%%%%%% %%%%% %%%%% % %%%
%     %       %%%       %       % %   %%%%%     %%% %%% %%%%% % %%%   %   %%%%%%%%%   %%%       % %%%
%%%%% % %%%%%%%%% %%%%% % %%%%% % % %%%%%%%%% %%%%% %%% %%%%% % %%%%% % % %%%%%%%%%%% %%%%%%% % % %%%
%     % %%%   %%% %%%%%   % %   % % %%%%% %%% %%%         %   % %%%%%   %     %%%%%%% %   %   % %   %
% %%% %%%%%%% %%%%%%%%%%%%% % %%%%% %%%%% %%%%%%% %%%%%%% % %%%%%%%%%%% %%% %%%%%%%%% % %%% %%% %%% %
% %   %%%     %%%%% %%%     % %     % %%%   %%%%%   %%%   %         %%% %%% %%%%%%%%% % %%% %%% %%% %
% %%%%%%%%% %%%%%%% %%% % % % % %%% % %%%%% %%%%%%% %%%%% %%% %%%%% %%%%%%% %%%%%%%%% % %%% %%%%%%% %
%     %   % %%%%%   %   % % %   %%%   %%%   %%%%%%% %%%%% %%% %%%%%   %%%       %%% %   %%% %%%     %
%%%%% % % % %%%%% % %%%%% % %%% %%%%%%%%% % %%%%%%%%%%%%% %%%%%%%%% %%%%% %%%%%%%%% %%% %%% %%% %%% %
% %%%   % %       % %%%   % %%%   %%%%%   % %%%%%%%%% %%% %%%%%%%   %%%%% %%%%%%%     %   %     %%% %
% %%%%%%% % %%%%%%% %%% %%%%%%% %%%%%%%%% %%%%%%%%%%% %%% %%%%%%% %%%%%%% %%%%%%% %%%%%%% %%% %%%%% %
% %%%%% % % %%%         %%%%%%% %%%%%     %%%%%%%%%   %%% %   %%% %%%       %%%   %%%     %%% %%% % %
% %%%%% % % %%% %%%%%%% %%%%%%% %%%%% %%%%%%%%%%%%% % %%% %%% %%% %%%%% %%%%%%% %%%%% %%%%%%%%%%% % %
%   %%% % % %%% %%%%%%% %%%%%%% % %%% %    !%%%%%%% %   % %   %%%   %%%   %%% %       %%%   %%%%%   %
% %%%%% % % %%%%%%%%%%% %%%%%%% % %%% % %%% %%%%%%%%%%% % % % %%%%% %%% % %%% % %%%%% %%%%% %%%%% %%%
% %%%   %S% %   %%%     %%%%% % % %%%   %%%   %%%%%%%   %   %     % % % %   %   %%%%%       %%% % %%%
% %%% %%%%% % % %%%%% %%%%%%% % % %%%%% %%%%% %%%%%%% %%% %%%%%%% % % % %%% % %%%%%%%%%%%%%%%%% % %%%
%       %%% % %   %%% %%% %%%       %%%     %   %%%%%     %%%%%%% % %   % %   %     %%%%%%%%%     %%%
% %%%%% %%% % %%% %%% %%% %%% %%%%%%%%% %%%%% % %%%%%%%%%%%%%%%%%%% %%% % %%% % %%% %%%%%%%%%%%%%%%%%
%   %%%     %   % %%% %%% %%% %%%%%%%   %%%   % %%%%%%%         %%% %%%   %%%   %%% %%% %%% %%%%%%% %
%%% %%%%%%% % %%% %%%%%%% %%% %%%%%%% %%%%% %%%%%%%%%%% % %%%%% %%% %%%%%%%%%%%%%%% %%% %%% %%%%%%% %
%%% %   %%%   %%%   %%%%%     %%%     %     %%%%%   %   % %%%%%       %%%%%%%%% %   %%%             %
%%% % %%%%%%%%%%%%% %%%%% %%%%%%%%%%%%% %%% %%%%% % % %%% %%%%%%% %%%%%%%%%%%%% % %%%%% %%%%% %%%%% %
%%%   %%% %%%%%%%%%       %%%%%         %%%   %   %   %   %%% %%% %%%%%%%%%%%%%   %     %     %%%%% %
%%%%% %%% %%%%%%%%% %%%%%%%%%%% %%% %%%%%%%%% %%% %%%%% %%%%% %%%%%%%%%%%%%%%%% %%%%%%%%% %%% %%%%% %
% %%% %%%       %%% %       %%% %%% %%%   %%%     %%%   %%%%% %%%%%%%%%%%%%%%   %%%       %%%   %%% %
% %%%%%%%%% %%%%%%% % %%% %%%%% %%%%%%%%% %%%%%%%%%%% %%%%%%% %%%%%%%%%%%%%%%%% %%% %%%%%%%%%%% %%%%%
%   %%%     %%%%% % % %   %%%%%   %%%%%%%   %%%%%%%%% %%%%%%%   %%%%%%%%%   %%%     %           %%%%%
%%% %%% %%%%%%%%% % % %%% %%%%% %%%%%%%%% %%%%%%%%%%% %%%%%%% %%%%%%%%%%%%% %%%%%%%%% %%% %%% %%%%%%%
%       %   %%%   %   %%% %%%%%     %%%         %       %%%%%     %%%   %%%   %%%%%%% %%% %%% %%%   %
% %%% %%% % %%% % %%%%%%% %%%%%%% %%%%%%%%%%% %%% %%%%% %%%%%%% %%%%%%% %%%%% %%%%%%% %%% %%%%%%% % %
% %   %%% %     %   %%%     %%%%% %%%   %%%%% %%%   %%%     %   %%%%%%%   %%%   %%%   %%%   %%%   % %
% %%%%%%% %%% %%%%% %%%%%%% %%%%% %%% % %%%%% %%% %%%%% %%% % % %%%%%%% %%%%%%% %%%%%%%%% %%%%%%% %%%
% %%%%%%% %%% %     %%%%%   %%%       % %%%%%     %%%   %%%   %   %%%   %%%%%   %%%%%%%%% %%%   % %%%
% %%%%%%% %%%%% %%%%%%%%% %%%%% %%%%%%% %%%%% %%% %%% %%%%%%%%%%% %%%%% %%%%% % %%%%%%%%%%%%% % % %%%
%     %     %%% %%%%%%%   %%%     %%% % %   % %%% %%% %%%     %%% %%%%%     % % %     %%%%%   %     %
% %%% % %%%%%%% %%%%%%% %%%%%%%%% %%% % % % % %%% %%%%%%%%% %%%%% %%%%% %%% % % % %%% %%%%% %%%%% %%%
%   % % % %%%     %   %       %%%     % % %   %%% %%%%% %%% %%%   %     %%%   %   %   %     % %%% %%%
% % %%% % %%% %%% % % %%%%%%% %%% %%%%% %%% %%%%%%%%%%% %%% %%% %%% %%%%%%%%%%% %%% %%%%%%% % %%% %%%
% %   %   %%% %%% % %   %%%   %   %%%   %%%   %%%%%         %%% %     %%% %     %%% %%%%%   %       %
% %%% % %%%%% %%% % % %%%%% %%%%%%%%% %%%%% %%%%%%% %%%%% %%%%% %%%%% %%% % %%%%%%% %%%%% %%%%% %%%%%
% %%%   %%%%%   %   % %%%   % %%%     % %%% %%%     %%%   %%%%% %     %%%   % %%%%%   %%% %%%%%   %%%
%%%%%%% %%%%%%% %%%%% %%% %%% %%% %%%%% %%%%%%% %%% %%% %%%%%%% % %%%%%%% %%% %%%%%%% %%% %%%%%%% %%%
%%% %%% %%%   % %   %     %     %   %     %%%%% %%% %%%   %%%%%   % %%%   %     %%% %   %   %%%%% %%%
%%% %%%%%%% %%% % %%%%%%%%% %%% %%% %%% % %%%%%%%%% %%%%% %%%%% %%% %%% %%% %%%%%%% %%% % %%%%%%%%%%%
%     %%%     %   %%%%%%%   % % %   %%% %   %%%%%%%   %%% %%%%% %%%   % %       %%%   %   %%%   %%%%%
%%% % %%%%% % %%% %%%%%%% % % % % %%%%% % %%%%%%%%% % %%%%%%%%%%%%% % % % %%% % %%%%% % %%%%% %%%%%%%
%   %   %%% % %%%   %%%   % %     %%%   %   %%%     % %%%%% %%%%%   % % % %%% %   %%%   %%%%%   %%%%%
% %%%%% %%%%% %%%%% %%% %%% %%% %%%%%%% %%% %%%%% %%%%%%%%% %%%%%%%%% % % %%%%% % %%%%%%%%%%% % %%%%%
% %%%   %%%   %%%%% % % % %   % %%% %%% %   % %%%   %%%%%   %%%%%     % %   %%% %   %%%%%%%%% % %%%%%
% %%% %%%%% %%%%%%% % % % %%% % %%% %%%%% % % %%%%% %%%%% %%%%%%% % %%% %%%%%%% %%%%%%%%%%%%%%% %%%%%
% %   %%%       %%% %     %%% % %%%   %%% %       % %%%   %%%%%   % %%%         %%%%% %%%%%       %%%
% %%%%%%%%%%% %%%%% %%% %%%%% %%%%%%% %%% %%%%%%% % %%% %%%%%%% %%%%%%%%%%%%%%% %%%%% %%%%%%% %%% %%%
%       %%%%%     %   % %%%%% %%%%%   %   %%%           %%%%%     %%%   %%%   %       %%% %%% %%%   %
% %%% % %%%%% % %%%%% %%%%%%% %%%%% % %%% %%% %%%%%%% %%%%%%%%%%% %%%%% %%%%% %%%%%%% %%% %%% %%% %%%
% %%% % %     %       %       % %%% %     %   %%%     %%%   %%%%%   %%% %%%%% %%%%%           %   %%%
%%%%% %%% %%% %%%%%%%%% %%%%% % %%% %%%%%%% %%%%%%%%% %%%%% %%%%% %%%%% %%%%% %%%%%%%%% %%%%%%%%%%%%%
%%%       %%% %%%       %%%   % %%%     %   %%%     % %%%%%   %   %%%%% %     %%%%%%%%% %%%%%%%%%%%%%
%%%%% %%%%%%%%%%% %%% %%%%%%% % %%%%%%% %%%%%%% %%% %%%%%%%%% % % %%%%% % % %%%%%%%%%%% %%%%%%%%%%%%%
%%%%%     % %%%   % % %%%%%%%   %%%%%%%   %   %   % %%%   %%%   %       % %     %%%     %%%%%%%%%%%%%
%%%%% %%% % %%% %%% % %%%%%%%%% %%%%%%%%% % % %%% % %%% % %%% %%%%%%%%% % %%%%% %%%%% %%%%%%%%%%%%%%%
%%%   %%%       %%%     %%% %%%     %%%%%   %     %     %   %     %%%%%   %%%%%   %%%   % %%%%%%%%%%%
%%% %%%%%%% %%% %%%%%%%%%%% %%% %%%%%%%%% %%%%% %%%%%%%%% % %%%%% %%%%%%% %%%%% %%%%%%% % %%%%%%%%%%%
%   %%%%%%% %%%   %%%%%%%       %%%%%%%%% %%%%%   %%%%%%% %         %%%%% %%%                 %%%%%%%
%%%%%%%%%%%%%%%%%%%%%%%%%%%%%%%%%%%%%%%%%%%%%%%%%%%%%%%%%%%%%%%%%%%%%%%%%%%%%%%%%%%%%%%%%%%%%%%%%%%%%
