%%%%%%%%%%%%%%%%%%%%%%%%%%%%%%%%%%%%%%%%%%%%%%%%%%%%%%%%%%%%%%%%%%%%%%%%%%%%%%%%%%%%%%%%%%%%%%%%%%%%%
%     %%% %%%%% %%%       % %%%%%%%%%%%%%%%%%%%%%   %                 %%%%%%%%%%% %%% %%% %   %%%%%%%
% % %%%%% %%%%% %%%%% %%% % %%%%%%%%%%%%%%%%%%%%% %%% %%% %%% %%% %%% %%%%%%%%%%% %%% %%% % % %%%%%%%
% %           %       %%%       %%%%% %%%%%%%%%   %   %%% %%% %%% %%%     %%%%%%% %%% %%%   %   %%% %
% %%%%%%% %%% %%%%% % %%%%%%% %%%%%%% %%%%%%%%%%% % %%%%% %%%%%%% %%%%%%%%%%%%%%% %%% %%%%% %%% %%% %
% %   %%%   %       % %%%%%%% %%%%%%%   %%%%%%%%%   %%%%%   %%% %         %%%%%%%     %%%%% %   %   %
% %%% %%%%% %%% %%%%%%%%%%%%% %%%%%%% % %%%%%%%%% %%%%%%% %%%%% %%%%%%%%% %%%%%%% % %%%%%%%%% % % %%%
% %%%   % %   % %%% %%%   %%%   %%%   %   %   %%% %%%   % %%%%%     %%%%%       % %     %%%%% % % %%%
% %%% % % %%% %%%%% %%% %%%%% %%%%% %%% % % %%%%%%%%%%% % %%%%% % %%%%%%%%% %%%%% %%%%% %%%%% % % %%%
%     %     %     %   %     % %%%%% %   %   %%%%%%%     %       % %%%%%%%%% %     %%%%% %     % %   %
%%%%%%%%% %%%%%%% % % % %%% % %%%%%%% %%%%% %%%%%%% %%% %%%%%%% %%%%%%%%%%% % %%%%%%%%% % %%% % % % %
%%% %     %%%     % %   %%% % %   %%% %%%%%     %   %   % %%%   %%%%%%%%%     % %%%   %   %%% %   % %
%%% % %%%%%%% % %%% %%%%%%% % %%% %%% %%%%%%%%% %%% % %%% %%%%% %%%%%%%%%%% %%% %%% % %%%%%%% %%%%%%%
%%%   %     % % %%%     % %       %%% %     %%% %%% % %   %%%%%   %   %%%%% %%%     % % %%%     %%%%%
%%% %%% %%%%% %%%%%%%%% % %%%%%%% %%% % % %%%%% %%% % %%% %%%%%%% %%% %%%%%%%%%%% %%% % %%%%%%% %%%%%
% % %   %%%%% %%%   %         %%%     % % %%%%%     %   % %%%     %   % %%%%%%%   % %   %       %   %
% % %%% %%%%% %%%%% % %%%%%%% %%%%% %%%%% %%%%%%%%%%%%% % %%%%% %%% % % %%%%%%% %%% % %%% %%%%% %%% %
% %   %   %   %%%%%   %%%%%%% %%%   %%%%%   %   %%% %       %%%     %   %%%%%%% %     %%% %   %     %
% %%% % %%% %%%%%%%%% %%%%%%%%%%%%% %%%%%%% % % %%% % %%% %%%%%%%%%%%%% %%%%%%% % %%% %%% %%% % %%%%%
%       %%% %%%   %%%   %%% %%%%%%%     %%% % % %%%   %%% %%%%%%% %%%%%   %%%   % %%%   % %%%   %%%%%
% %%% %%%%% %%% % %%%%%%%%% %%%%%%%%%%%%%%% % % %%% %%%%%%%%%%%%% %%%%%%% %%% % %%%%%%%%% %%%%%%%%%%%
% %%% %%%   %   %           %%%%%%%%%%%%%     %   % %%%%%%% %%%   %%%         % %%%%%%%%%   %%%%%%%%%
% %%%%%%%%% % %%%%%%%%%%%%% %%%%%%%%%%%%%%%%% %%% % %%%%%%% %%% %%%%%%% %%%%%%% %%%%%%%%%%% %%%%%%%%%
%   %%%%%%% %   %%%%%%%%% % %%%%%%%   %%%%%%%   % % %%%%%   %%% %%% %%%   %%%       %%% %%% %%%%%%%%%
%%% %%%%%%% %%% %%%%%%%%% % %%%%%%%%% %%%%%%% %%% % %%%%% %%%%% %%% %%%%%%%%% %%%%% %%% %%% %%%%%%%%%
%   %%%%%%%         %     % %%%%%%%%%   %%%%% %%%         %%%%% %%% %%%%%%%     %%% %%% %       %%%%%
% %%%%%%%%% %%%%%%% % % %%% %%%%%%%%% %%%%%%%%%%%%%%%%%%% %%%%% %%% %%%%%%%%%%% %%% %%% % %%% %%%%%%%
%   %%%%%     %%%%%   % %%%       %%% %%%   %%%%%%%%%                 %%%%%%%%% %%% %%%     %     %%%
%%%%%%%%%%%%% %%%%%%%%%%%%% %%%%% %%% %%%%% %%%%%%%%%%%%%%% %%%%%%%%%%%%%%%%%%% %%%%%%%%% %%% % %%%%%
%%%%%   %%%%% %         %   % %%% %   %%%%%   %%%%%%%%%%%%% %%%%%%%%%%%%%%%%%%%   %%%%%%% %%% % %%% %
%%%%% %%%%%%%%% % %%%%% %%% % %%% % %%%%%%% % %%%%%%%%%%%%%%%%%%%%%%%%%%%%%%%%% %%%%%%%%%%%%%%% %%% %
%               % %%%       %   % % %%%     % %%%         %%%%%%%%%%%%% %%% %   %%%%%%%%%%%%%%%     %
% %%%%%%%%% %%%%% %%%%%%%%%%%%% % % %%% %%%%% %%%%% % %%%%%%%%%%%%%%%%% %%% % %%%%%%%%%%%%%%%%%%% % %
% %%% %%%%% %%%%% %%%%%%%   %%% %       %%% % % %%% % %%%%%%%%%%%%%%%%%     % %   %%% %%%       % % %
% %%% %%%%% %%%%% %%%%%%%%% %%% % %%% %%%%% % % %%% %%%%%%%%%%%%%%%%%%% %%% % % % %%% %%% %%% %%% % %
%   %   %%% %     %%%   %%%     % %%% %%%   %   %   %%%     %%%%%%%%%%% %%% % % %         %%% %   % %
%%% % %%%%% %%% %%%%% % %%% %%% % %%%%%%% %%%%% % %%%%% % %%%%%%%%%%%%% %%%%% %%% %%%%% %%%%%%% %%% %
% % % %%%     % %%%   %   % %%% % %%%%%     %     %%%   %     %%%%%%%     %%%     %%%%% %%%     % % %
% % % %%% %%% %%%%%%% %%% % %%%%% %%%%% %%% % %%%%%%%%%%% %%% %%%%%%%%% %%%%% %%% %%%%%%%%% %%%%% % %
% %   %%% %   %%% %%%   %   %%%%%   %%%   %   %%%%% %%%%% %%%           %%%%% %%% %     %   %%%%%   %
% %%% %%%%% %%%%% %%% % %%%%%%%%%%% %%%%% %%%%%%%%% %%%%%%%%%%% %%% %%%%%%%%% %%%%% %%% %%% %%%%%%% %
%     % %%%     %     %         %   %%%%%   %%%         %%%%%%% %%%       %%%   %   %     % %   %%% %
% %%%%% %%%%% % % %%% %%%%% %%%%% %%%%%%%%%%%%%%% %%% %%%%%%%%% %%%%%%% % %%% %%% %%%%%%% % % % %%% %
%         %%% % % %%%   %%%       %   %     %%%%%   % %%%     %     %%% % %   %%% %%%%% % %   % %   %
%%%%% %%%%%%%%% % %%%%%%%%% %%%%%%% % % %%% %%%%%%% %%%%% %%% %%% %%%%%%% % %%%%% %%%%% % %%%%% %%%%%
%%%%% %%%%%     % % %%%%%%%   %     %   %%% %%%     %%%%% %%%     %%%%%%%   %%%     %%% %   %%% %%%%%
%%%%% %%%%%%% %%% % %%%%%%%%%%% %%%%% %%%%% %%% % %%%%%%%%%%%%% %%%%%%%%% %%%%%%% %%%%% %%% %%% %%%%%
%%%%% %%% %%% %     %       %%% %%%%% %%%       % %%% %%%%%%%%% %%%%%%%%% %%%     %%%%%     %%%     %
%%%%% %%% %%% %%%%%%% %%%%% %%% %%%%%%%%% % %%%%% %%% %%%%%%%%% %%%%%%%%%%%%%%% %%%%%%%%% %%%%%%% %%%
%%%%%     %%%   %%%%%     % %     %%%%%   % %%%       %%%%%%%   % %   % %%%     %%%   %%% %       %%%
%%%%% %%% %%%%% %%%%%%%%% % % %%% %%%%%%%%% %%%%%%%%% %%%%%%% %%% % % % %%% %%%%%%% %%%%% % %%%%% %%%
%%%%% %%% %   %     %%% % %   %%%     %%%%%       %%%   %%% %     % %       %           % % %%% %   %
%%%%%%%%% %%% %%%%% %%% % %%%%%%%%%%% %%%%% %%%%% %%%%%%%%% %%%%% % % %%% %%% %%%%% %%% % % %%% %%% %
% %%%%%%% %   %%%%% %%% % %%%   %%%%% %%%   %%%%%   %%%%%         % % %%% %     %%% %%% % % %   %%% %
% %%%%%%% % %%%%%%% %%% % %%% %%%%%%% %%%%%%%%%%%%% %%%%% %%%%%%%%% %%%%%%% %%%%%%%%%%% % % %%% %%% %
% %%%     % %%%         % %%% %%%       %%%%%   %%%       %%%%%%%%% %       %%%         %   %%%     %
% %%% %%%%% %%% % %%%%%%% %%% %%%%% %%%%%%%%% % %%% %%% %%%%%%%%%%% % %%% %%%%% %%%%%%%%%%%%%%% %%% %
%     %%%   %%% %       %   %   %%%   %%%%%%% %   % %%% %%%%%   %%% % %%% %%%   %%%%%   %%%     %%% %
%%% %%%%% %%%%%%%%%%% % %%% % % %%%%% %%%%%%%%%%% % %%%%%%%%%%% %%% % %%%%%%% % %%%%% % %%% %%%%%%% %
%%%       %%% %%%%%%% %     % % %   %   %%% %%%%%     %%%       %%%   %%%%%%% %   %%% %       %%%%% %
%%% %%%%% %%% %%%%%%%%% %%%%% % % % %%%%%%% %%%%%%%%%%%%%%% % % %%% %%%%%%%%% %%%%%%% %%% %%%%%%%%%%%
%   %%%%% %%%     %%%%%       % % % %%%   %     %%%%%   %%% % % %%% %%% %%%%% %%%%%   %%%   %%%   %%%
% %%%%%%%%%%% %%% %%%%% %%%%%%% % % %%% % %%% %%%%%%% % %%%%% %%%%% %%% %%%%% %%%%%%% %%%%% %%%%% %%%
%   %%% %%%%% % %   %%% %%%%%   % %     %     %%%%%   %   %%% %%%   %%%   %%%     %%%   %%% %       %
%%%%%%% %%%%% % % %%%%%%%%%%%%% % %%%%%%%%% %%%%%%%%% % %%%%% %%%%%%%%% % %%% % %%%%%%%%%%% % %%%%% %
%%%%%       %   % %%%%%%%%%%%%% % %       % %%%       % %%%     %%%%%   %     % %%% %%%%% %   %%%%% %
%%%%% %%%%% % %%% %%%%%%%%%%%%% % % %%%%% % %%%%%%% %%% %%%%%%% %%%%% %%% %%% %%%%% %%%%% % %%%%%%%%%
% %   % %%%   %%% %%%%%%%%%%%   %   %%%   % %       % % %         %%% %%% %%%       %%%   % %%%   %%%
% % %%% %%%%%%%%% %%%%%%%%%%%%% %%%%%%% %%% % %%% %%% % % % %%% %%%%%%%%%%%%% % % %%%%% %%% %%%%% %%%
%     %       %%% %%%%%%%%%%%%%   %%%   %%%   %   %%% % % % %%% %%%       %   % % %%%     %         %
% %%% % %%%%%%%%% %%%%%%%%%%%%%%% %%%%% %%%%%%% %%%%% % % %%%%% %%% %%%%% %%%%% %%%%% %%% %%%%%%%%% %
% %%%   %%%%%%% %   %%%%%%%%%%%%%   %%% % %%%   %%%   %   %%%   %%% %%%%%   %%% %%%   %%%       %%% %
%%%%%%%%%%%%%%% % % %%%%%%%%%%%%%%%%%%% % %%% %%%%%%% %%% %%%%%%%%% %%%%%%% %%% %%%%% %%% %%%%% %%% %
%%%%%%%%%         %     %%%%%%%%%%%%%%% %     %%%%%%% %     %%%%%%%     %%%   %     % %%%   %%%     %
%%%%%%%%% %%%%%%% % %%% %%%%%%%%%%%%%%% %%%%%%%%%%%%% % %%%%%%%%%%%%% %%%%%%% %%%%% %%%%% %%%%% %%%%%
%%%%% %%% %%%%%%% % %%%   %%%%%%%%%%%   %%%%%%%%%%%     %%%%%         %%%%% % %%%%% %%%   %%%%% %%% %
%%%%% %%% %%%%%%%%% %%%%%%%%%%%%%%%%%%% %%%%%%%%%%%%% %%%%%%% % %%%%%%%%%%% % %%%%% %%%%%%%%%%% %%% %
%%%   %%% %%%%%%%   %%%%%%%%%%% %%%     %%%%% %%%%%%%     %%% %     %%%%%   % %%%     %%%%%%%       %
%%% %%%%% %%%%%%% %%%%%%%%%%%%% %%%%% % %%%%% %%%%%%%%% %%%%% %%%%% %%%%% % % %%% % %%%%%%%%%%%%%%% %
%   %%%%%     % %       %%% %%%   %%% % %%%     %%% %%% %%%   % %%%   %%% % %     % %%%%%%%%%%%     %
% % %%%%%%%%% % %%%%% % %%% %%% %%%%% %%%%%%% % %%% %%% %%%%% % %%%%% %%% % % %%%%% %%%%%%%%%%%%%%%%%
% % %%%%% %%%   % %   % %%%     %%%%%   %%%%% %       %   %%% %     % %%% %   %%%%% %   %%%%%%%%%%%%%
%%% %%%%% %%%%% % % %%%%%%%%% % %%%%%%% %%%%% % %%% %%%%% %%% % %%% % %%%%%%%%%%%%% % %%%%%%%%%%%%%%%
%%%       %%%   % %       %%% %   %%%   % %   %   % %%%   %%% % %%% %       %%% %     %%%%%%%%% %%%%%
%%%%% %%%%%%% %%% %%%%%%% %%% %%% %%% %%% % %%%%% % %%% %%%%% % %%% %%%%%%% %%% % %%% %%%%%%%%% %%%%%
% %%%         %     %     %   %   %   %%%   %%%   %   % % %%%   %%%   % %%% %%%   %%% %%% %%%%%   %%%
% %%% %%% %%%%% %%%%% %%% % % %%% %%% %%%%%%%%% %%% %%% % %%%%% %%%%% % %%% %%%%%%%%% %%% %%%%% %%%%%
%     %%% %%%%% %%%   %     % %%% %   % %%%%%   %%% %%%     %%%   %%%   %%%   %%%%%%%   %   %       %
%%% %%%%% %%%%% %%% %%%%% %%%%%%% % %%% %%%%%%% %%%%%%%%%%% %%%%% %%%%% %%% %%%%%%%%%%% % % % %%%%% %
%%% %%%   %     %%% %%%%% %%%%%   %   %   %%%%% %%%%%%%%%%%   %%% %%%%% %%% %%%       %   % %   %   %
%%%%%%% %%% %%% %%% %%%%% %%%%%%% %%% %%% %%%%% %%%%%%%%%%% %%%%% %%%%%%%%% %%%%% %%%%%%%%% %%%%% %%%
%%%%%   %%% %     % % %     %%%%%     %%%   %%%   %%% %%% % %%% %   %%%%%     %%%     %%% % %%%%%   %
%%%%% %%%%%%% %%% % % % %%%%%%%%%%% %%%%% %%%%%%% %%% %%% % %%% % %%%%%%%%% %%%%%%% % %%% % %%%%%%% %
%%% % %       %   % %   %%%%%   %   %%%   %%%     %%% %%% % %%%   %%%       %%%%%%% % %   % % %%%   %
%%% % %%% %%% %%%%% %%%%%%%%%%% % %%%%% % %%% % %%%%% %%% % %%%%%%%%% %%%%% %%%%%%%%% % % % % %%% % %
%%%       %%% %S%   %%%%%%%%%%%   %%%   % %   %             %%%%%%%%% %%% % %   %%%%% % % %       % %
%%%%%%%%%%%%% % % % %%%%%%%%%%%%%%%%%%% %%% %%%%%%%%% %%%%%%%%%%%%%%% %%% % % % %%%%% % % % %%%%%%% %
%%%%%         %   %   %%%%%%%%%%%%% %%% %%%       %%%   %%%%%         %%%     % %%%   % %   %%%%%   %
%%%%%%% %%%%% %%%%%%% %%%%%%%%%%%%% %%% %%%%% %%%%%%%%% %%%%%%% %%%%% %%%%%%% %%%%% %%% %%% %%%%% %%%
%%%%%%% %%%%%   %%%     %%%%%%%%%             %%%%%             %%%%%!  %%%%% %%%%%     %%%   %%% %%%
%%%%%%%%%%%%%%%%%%%%%%%%%%%%%%%%%%%%%%%%%%%%%%%%%%%%%%%%%%%%%%%%%%%%%%%%%%%%%%%%%%%%%%%%%%%%%%%%%%%%%
