%%%%%%%%%%%%%%%%%%%%%%%%%%%%%%%%%%%%%%%%%%%%%%%%%%%%%%%%%%%%%%%%%%%%%%%%%%%%%%%%%%%%%%%%%%%%%%%%%%%%%
%       %%% %%%     %%%       %%% %%%   %%%       %%% %%%%%   %%% %%%%%         %       %       %%%%%
% %%% %%%%% %%% %%%%%%% %%% % %%% %%%%% %%% % %%% %%% %%%%% % %%% %%%%%%%%% %%% % %%%%% %%%%% %%%%%%%
%   %           %%%%%   %%% %           %%% % %%% %     %%% % %%%           %%%   %%%%% %%%   %%%%%%%
%%% %%%%%%% % %%%%%%% %%%%% %%%%%%% %%%%%%%%% %%% %%% %%%%%%% %%%%% % %%%%%%%%%%%%%%%%% %%% %%%%%%%%%
%%% %%%%%%% %     %%% %%%   %       %%%   %%% %%% %%% %%%%%%%     % % %%%%%           % %   %%%%%%%%%
%%% %%%%%%% %%%%% %%% %%%%% %%%%%%% %%% % %%% %%% %%% %%%%%%%%% % %%% %%%%% %%%%% %%% % %%% %%%%%%%%%
%   %%%   % %%%%%   %   %%%       % %%% %     %   %   %%%   %%% %   % %   %   %   %%% %   %     %%%%%
%%%%%%% % % %%%%%%% %%% %%%%%%%%% %%%%% %%% %%% %%% % %%%%% %%% %%% % % % %%% %%% %%% %%% %%%%% %%%%%
%%%%%%% % % %     %   % %       % %%% % % % %   %   %           %%%   % %     %%% %%% %   %%%   %%%%%
%%%%%%% %%% % %%%%% % % % %%% %%% %%% % % % %%% % %%%%%%% %%%%%%%%%%%%% %%%%%%%%% %%%%% %%%%% %%%%%%%
% %     %%%   %%%%% % % % %   %%%         % %%%   %       %%%%%%%%%%%   %%%%%%%%% %%%%% %%%       %%%
% % % %%%%%%% %%%%%%% % % %%% %%%%%%%%% %%% %%% %%%%%%%%%%%%%%%%%%%%%%% %%%%%%%%%%%%%%% %%%%%%% % %%%
% % %   %%% %   %%%%%   %   %   %   %%% %   %%% %%%%%%%%%%%     %%%%%%%   %       %     %   %   % % %
% % %%% %%% % %%%%%%% %%%%% %%% % % %%%%% %%%%%%%%%%%%%%%%% %%% %%%%%%% % % %%%%% % %%%%% % % %%% % %
%     %       %%%   % %     %%%   % %     %%%%%%%%%     %     %   %%%%% %   %%%%%   %%%   %   %%% % %
% %%% %%%%%%%%%%% %%% % %%% %%%%% %%% %%% %%%%%%%%%%% %%% %%% %%% %%%%%%% %%%%%%%%%%%%%%% %%%%%%% % %
% %%% %%%     %   %%%   %     %%% %   %   %%%%%%% %%% %%% %   %%%   %%%%%       %%%%%     %%%       %
% %%% %%% %%% %%% %%% %%%%%%% %%%%% % %%%%%%%%%%% %%% %%% % %%%%%%% %%%%%%%%%%% %%%%%%% %%%%% %%%%% %
% %%%   % %%%   %     %   %   %     % %%%   %%%%%   %     % %%%     %   %   %%% %%%   % %%%%% %%%%% %
%%%%%%%%% %%%%% %%%%%%% % %%%%% %%% %%%%% % %%%%% %%% %%%%% %%%%%%%%% % % % %%% %%% % % %%%%% %%%%% %
%%%%%       %%% %%%     %       %%% %%%   % %%%%%     % %%% %       % % % %   %     %   %   % %%%   %
%%%%% %%%%%%%%% %%% %%%%% %%%%%%%%%%%%% %%% %%%%% %%% % %%% % %%%%% % % %%% %%%%% %%%%%%% %%% %%% %%%
%     %%%%%%%       %%%   %%%%%%%%%     %%% %%%%% %%%     %     %%%   %   %       %%% %%% %   %%% %%%
%%%%% %%%%%%%%%%% %%%%%%% %%%%%%%%% %%%%%%% %%%%%%%%%%%%% %%%%%%%%%%%%%%% % %%%%%%%%% %%% % %%%%%%%%%
%%%%%   %   %%%   %%%%%%% %%%%% %%% %%%%%   %   %%%%%%%%% %%% %%%   %     %     %%%%%           %%%%%
%%%%% % %%% %%% %%%%%%%%% %%%%% %%% %%%%% % % %%%%%%%%%%% %%% %%% % % %%%%%%%%% %%%%% %%%%%%% %%%%%%%
%     % %%% %%% %%%%%%%   %%%%%     %%%   %   %%%%%%%%%%% %%%     % %   %%%%%%% %%%     %%%   %%% %%%
% %%%%% %%% %%%%%%%%%%%%%%%%%%% %%% %%% % %%%%%%%%%%%%%%% %%% %%%%% %%% %%%%%%% %%%%% %%%%%%% %%% %%%
% %   %   %   %%%     %%%%%%% % %%% %%% %   %%%%%%%%% %   %   %%%   %%% %%%%%%%   %%% %%% %%% %%%   %
% %%% %%% %%% %%%%% %%%%%%%%% % %%%%%%%%% % %%%%%%%%% % %%% %%%%% %%%%% %%%%%%%%%%%%%%%%% %%%%%%%%% %
%   %       %       %%%   %%% %   %%%%%%% % %%%%%%%     %       % %%%     %%%   %%%%%%%     %%%%%%% %
% % %%%%%%% % %%%%% %%%%% %%% % %%%%%%%%%%% %%%%%%% %%%%% %%%%%%% %%%%% % %%% % %%%%%%% %%% %%%%%%% %
% %     %%%   %%%           % % %%%     %%% %%%%%     %%% %%%%%%% %%%%% %     %     %%% %%%   %%%%% %
%%% %%% %%%%% %%%%%%%%%%%%% % % %%%%% % %%% %%%%%%%%% %%%%%%%%%%% %%%%%%%%%%%%%%%%% %%% %%%%% %%%%% %
%%% %%%   %%%   %%%%%   %   % %   %%% %         %%% % %%%%%           %%%     %%%%% %   %%%%%       %
%%% %%%%% %%%%%%%%%%% %%% %%% %%% %%% %%%%%%% %%%%% % %%%%% % %%% %%% %%% %%%%%%%%% % %%%%%%%%%%% % %
% % %%% %     %%%         %   %     % %     % %%%%%   %%%%% % %   %%%     %%%%% %%%   %       %%% % %
% % %%% %%%%% %%% %%%%% %%% %%% %%%%% % %%% %%%%%%% %%%%%%%%% %%%%%%% %%% %%%%% %%% %%% %%%%% %%% % %
%       %     %%%   %%%     %%% %%%%% %   % %%%   %   %%% %%% %     % %%%   %%%     %   %%%%%   % % %
% %%%%%%% %%% %%%%% %%%%%%%%%%% %%%%% % %%% %%% % %%% %%% %%% % %%% %%%%%%% %%%%%%%%% % %%%%%%% %%% %
%   %     %     %%% %         %     %   %%% %%% % %%%   %     % %%%     %   %%%       %     %%%     %
%%%%% %%%%% %%%%%%%%% %%%%%%% %%% %%%%%%%%% %%% %%%%%%% %%% % % %%% %%% %%%%%%% %%%%%%%%% %%%%%%% %%%
%%%   %     %%%%% %%%   %   %     %%% %%% %           %   % % %   % %%%     %   %         %%%%%%% %%%
%%% %%%%% %%%%%%% %%%%% %%% %%%%%%%%% %%% %%%%%%%%%%% %%% % %%%%% %%%%%%%%% % %%%%%%%%%%%%%%%%%%%%%%%
%   %%%%% %%%%%         %%% %%%%%%%           %%%%%%%   %   %%%   %%%%%%% % %                 %%%%%%%
%%% %%%%%%%%%%% %%%%%%%%%%% %%%%%%% %%%%% %%%%%%%%%%%%% % %%%%% %%%%%%%%% % %%% %%%%%%%%%%%%% %%%%%%%
%       %%% %%% %     %%%%%   %%%%% %%%%% %%%%% %%%     % %%% %   %%%       %%% %%%%%         %%% %%%
% %%% %%%%% %%% %%% % %%%%%%% %%%%%%%%%%% %%%%% %%%%% %%% %%% %%% %%% %%%%%%%%% %%%%% %%%%% %%%%% %%%
% %%% %%%       %%% %     %%%     %%%       %%% %%%   %%%     %%% %     %     % %   %   %%% %%%%%   %
% %%%%%%%%%%% %%%%%%%%%%% %%% %%% %%% % %%%%%%% %%% %%%%%%% %%%%% % %%% % %%% % %%% %%% %%%%%%%%% %%%
%   %%% %%%%% %%%%%%%     %%% %   %%% % %%%%%               %%%   % %%%   %   %     %%%           %%%
% %%%%% %%%%% %%%%%%% %%% %%%%% %%%%%%% %%%%%%% %%%%%%%%%%%%%%% % %%%%%%%%% %%% %%%%%%%%% %%%%% %%%%%
%       %%%   % %%%   %%%       %%%     %%% %%% %%%%% %         % %%% %%%%% %%% %%%%%%%%% %%%%%     %
%%% %%%%%%% %%% %%% %%%%%%%%%%% %%% %%% %%% %%%%%%%%% % %%%%%%% %%%%% %%%%% %%%%%%%%%%%%%%%%%%%%% %%%
%%%                 %%% %%%%%%%     %   %%%   %%%     %     %%% %%%%%     % %%%%%%%%%%% %%%   %%% %%%
%%% %%%%%%%%%%%%%%%%%%% %%%%%%%%% %%%%% %%% %%%%%%%%% %%%%% %%%%%%%%% %%% % %%%%%%%%%%% %%% %%%%% %%%
%   %%%%%%%%%     %%%%%       %%% %%%%%     %%%%%%%   %%%%%       %%%   %   %%%%%%%%%     %   %%%   %
%%%%%%%%%%%%% % %%%%%%% % %%% %%%%%%%%%%%%% %%%%%%% %%%%%%%%%%% %%%%% %%%%% %%%%%%%%% %%% %%% %%%%% %
%%%%%     %   % %%%     % %%%   %%%%%%%   % % %%%   %%%         %%%%% %%%%%   %%%     %%%       %%% %
%%%%% %%%%% %%% %%% %%% % %%%%%%%%%%%%% %%% % %%% %%%%% %%%%%%%%%%%%%%%%%%%%% %%%%%%% %%%%%%% %%%%% %
%%%         %%% %%% %   % %     %%%%%           % %     % %%%     %%%%%%%%%%%   %%%   % %%%   %%%%% %
%%% %%% %%%%%%% %%% % %%%%% %%% %%%%% %%%%%%%%% % % %%%%% %%% %%% %%%%%%%%%%% %%%%% %%% %%%%% %%%%% %
% % %%% %%%%%%%     %       %%%     %     %%%     % %     %     %   %%%%%%% % %%%   %%%   %%% %%%   %
% % %%%%%%%%%%%%% %%%%% %%%%%%%%%%% % %%%%%%% %%% % %%%%% % %%% % %%%%%%%%% % %%%%% %%% %%%%% %%% %%%
% %   %%%%%%% %%%   %%%   %%%%% %%%   %%%%%   %%% %   %%%   %%% % %%%%%%%%%   %     %             % %
% % %%%%%%%%% %%%%% %%%%% %%%%% %%%%% %%%%% %%%%%%%%% %%%%% %%% % %%%%%%%%% %%% %%% %%%%% %%% %%%%% %
%   %%%       %%%%% %%% % %     %%%%%   %%% %%% %%%%% %%%%% %%% %   %%%     %%% %%% %%%%% %%% %%%%% %
% %%%%%%% % %%%%%%%%%%% % %%% %%%%%%%%% %%%%%%% %%%%% %%%%%%%%% % %%%%%%% %%%%% %%% %%%%%%%%%%%%%%% %
%     %%% % %%%%%%%%%   % %   %%%%%       %     %%%%%   %%%     % %%% %%%       %       %%% %%%%%   %
%%%%% %%% % %%%%%%%%% %%% % % %%%%%%% %%% % % %%%%%%% %%%%% % %%% %%% %%%%%%%%%%%%%%% %%%%% %%%%% % %
%%%     % % %%%%%%%       % % %%%%%%% %%% % % %%%%%   %%%   % %%% %   %%% %%%   %%%%% %%%         % %
%%%%%%% %%% %%%%%%% %%% %%% %%%%%%%%%%%%%%% % %%%%%%% %%% %%% %%% % % %%% %%%%% %%%%%%%%%%%%% %%%%% %
% %%%%%     %%%%%%% %%% %%% %%% %%%%%%%     % %%%%%%% %   % % %%%   % %     %%% %%% %%%%%%%%% %%%   %
% %%%%%%%%%%%%%%%%% %%%%%%% %%% %%%%%%%%% %%% %%%%%%% %%% % % %%%%%%% % %%% %%% %%% %%%%%%%%% %%% %%%
%   %%%%%%%%%%%%%%% %%%%%%% %%%S% %%%     %%%     %   %%% %   %%%%%%% % %   %         %%%   %   %   %
% % %%%%%%%%%%%%%%% %%%%%%% %%% % %%% %%%%%%%%%%% %%% %%% %%%%%%%%%%% %%% %%% %%%%% %%%%% %%% %%% % %
% % %   %%%%%%%             % %       %%%   %%%       %%%       %%%   %%%     %%%%% %%%%% %   %%% % %
% % % %%%%%%%%%%%%%%%%%%%%% % %%%%%%%%%%%%% %%%%%%%%%%%%%%%%% %%%%% %%%%%%% %%%%%%% %%%%% % %%%%%%% %
% %   %%%%%%% %%%%%%%   %         %%%     %   %%%%%           %%% % %%% %%%     % %       % %%%     %
% %%% %%%%%%% %%%%%%%%% % %%%%% %%%%% %%% % % %%%%% %%% %%%%%%%%% % %%% %%%%%%% % %%%%% %%% %%% %%% %
% %%% %           %%%%%   %%%%% %%%   %%%   %   %   %%%         %         %%%%%   %%%%%     %   %   %
% %%%%% %%%%%%% %%%%%%%%%%%%%%% %%% %%%%%%%%%%% % %%%%%%%%% %%% % %%%%%%% %%%%%%%%%%%%% %%%%% %%% %%%
%         %%%   %%%   %%%%%%%       %   %     % % %%%%% %%%   % %   %%%         %     % %%%%% %%% %%%
% %%%%%%%%%%% %%%%% % %%%%%%%%%%%%%%%%% % %%% % % %%%%% %%% %%% %%%%%%%%%%% %%% % %%% %%%%%%% %%% %%%
%   %%%%%     %%%%% % %%%   %%%%%   %%%     %   %   %   %%% %%% %%%%%%%%%%% %%%   %%% %%%     %%%   %
% %%%%%%% %%% %%%%% % %%% % %%%%% %%%%%%%%% %%%%%%% % %%%%%%%%% %%%%%%%%%%%%%%%%%%%%% %%% % % %%%%% %
% %%%       %   %%% %     % %%%   %%% %%% %     %%%   %       %   %%%   %%%%% %%%%% % %   % %   %%% %
% %%% %%%%% %%%%%%% %%%%%%% %%% %%%%% %%% %%%%% %%%%% % %%%%% %%% %%%%% %%%%% %%%%% % %%%%% % %%%%%%%
% %%%   %%% %%%%%%%       % %%% %%%         %%% %%%   % %   %   %   %%%   %%%   %           % %%%%%%%
%%%%%%% %%% %%%%%%% %%%%% %%%%% %%%%% %%% %%%%% %%%%%%% %%% %%% % % %%% %%%%% %%% %%%%%%% %%% %%%%%%%
%%%%%%%   %     %%% %%% %             %%% %     %%%%%   %   %%%   % %%% %%%%%     %%% %%% %%% %%%   %
%%%%%%% %%%%% % %%% %%% %%%%% %%% %%%%%%% % %%%%%%%%% %%% % %%%%%%% %%% %%%%%%% %%%%% %%%%%%% %%%%% %
%%%%% % %%%%% %     %%%   %%% %   %%%%%%% %           %%% %   %%%           %%%       %%%%%   % %%% %
%%%%% % %%%%% %%%%% %%%%% %%% %%%%%%%%%%%%% %%%%% %%%%%%% %%%%%%% %%% %%% %%%%%%%%% %%%%%%%%% % %%% %
%%%%%   % %%% %%%%% %%%%% %%%   %%%         %%%   %%%%%%%   %     %%% %%% %%% %%%   %%%%%%%%%       %
%%%%% %%% %%%%%%%%% %%%%% %%%%% %%% %%% %%%%%%%%%%%%%%%%% % % %%%%%%% %%%%%%% %%% %%%%%%%%%%% %%%%% %
%     %%%   %%%%%%%   %%%   % %     %%%   %%% %%%%% %%% % %   %%%%%%%!% %%%     % %   %%%%%%% %%%   %
% %%% %%% % %%%%%%%%% %%% % % %%% %%%%%%% %%% %%%%% %%% % %%%%%%%%%%% % %%%%% % % % %%%%%%%%% %%%%% %
% %%%     %   %%%%%       %   %%% %%%     %%%                 %%%%%%%     %%% %     %%%%%%%     %%% %
%%%%%%%%%%%%%%%%%%%%%%%%%%%%%%%%%%%%%%%%%%%%%%%%%%%%%%%%%%%%%%%%%%%%%%%%%%%%%%%%%%%%%%%%%%%%%%%%%%%%%
