%%%%%%%%%%%%%%%%%%%%%%%%%%%%%%%%%%%%%%%%%%%%%%%%%%%%%%%%%%%%%%%%%%%%%%%%%%%%%%%%%%%%%%%%%%%%%%%%%%%%%
%       %%%       %%% %%%%%%%     %     %%%%%%%%%%%%%%% %%%%%         %   %%%       %   %%%%%%%%%%%%%
% %%%%% %%%%% % %%%%% %%%%%%%%% % %%% % %%%%%%%%%%%%%%% %%%%% %%%%%%% % % %%% %%%%% % % %%%%%%%%%%%%%
% %%%   %%%%% %         %%%%%   % %%% % %%%%%%%%%%%%%         %%%       % %%% %%%%% % %   %%%       %
%%%%% %%%%%%%%% %%% %%%%%%%%% %%% %%% % %%%%%%%%%%%%%%%%% %%%%%%%%%%%%% %%%%% %%%%% % %%% %%% %%%%% %
%%%         %%% %%% %%%%%     %%%     % %%%%%%%%%%%%%%%   %%%     %   % %%%     %%% %   %     %%%%% %
%%% %%% %%% %%%%%%% %%%%% %%%%%%% %%% %%%%%%%%%%%%%%%%% %%%%% %%% % % %%%%% %%%%%%%%%%% %%% % %%%%%%%
%   %%% %     %%%   %%%%%     %%% %%% %%%%%%%%%%%%%             %   % %%%     %     %%% %%% % %%%%%%%
%%%%%%% %%%%% %%% % %%%%% %%% %%% %%% %%%%%%%%%%%%% %%%%% %%%%%%% %%% %%% %%% % %%% %%% %%%%% %%%%%%%
%%%%%   %%%%% %   % %%%     % %   %%%   %%%%%%%%%     %%%   % %%%   %   %   %     %     %%%   %%%%%%%
%%%%% % %%%%% % %%% %%%%% %%% % %%%%%%% %%%%%%%%% %%%%%%%%% % %%%%% %%% % %%%%% %%%%%%%%%%% %%%%%%%%%
%     % %%%     %%%   %%% %%% %   %%%%% %%% %%%%% %%%%% %%%   %%%     %   %%%%% %%%     %%% %%%     %
%%% %%%%%%% %%%%%%%%% %%%%%%% % %%%%%%% %%% %%%%% %%%%% %%%%% %%%%%%% %%%%%%%%%%%%% %%%%%%% %%%%% %%%
%%%   %%%%% %%%%% %%%   %%%   % %%%       %   %%% %%%       %   %%% %   %%%%%%%%%%% %%%       %%%   %
%%%%% %%%%%%%%%%% %%%%%%%%% % %%%%%%%%%%% %%% %%%%%%%%%%% %%% %%%%% %%% %%%%%%%%%%% %%% %%%%% %%%%% %
%%%   %   %%%%%%%   %%%%%   % %%% %%%%%   %           %%%     %%%   %%% %%%%%%%%%   %%% %%%%%   %%% %
%%% %%% % %%%%%%%%% %%%%% %%%%%%% %%%%% %%% % %%%%%%% %%% %%%%%%%%% %%% %%%%%%%%% %%%%% %%%%%%%%%%% %
%%%     %     %%%     %%%   %%%%%     % %   % %%%   % %%%   %%% %%% %%%     %%%   %%%   %%%%%       %
%%% %%% % %%%%%%% %%% %%%%% %%%%% %%% % %%% %%%%% % % %%%%%%%%% %%% %%%%% %%%%% %%%%% %%%%%%% %%%%% %
%%% %%% % %       %%% %     %     %%%   %%% %%% % %   %%%%%%%             %%%       %   %     %%%%% %
%%%%%%%%% % %%% %%%%% %%% % %%% %%%%%%%%%%% %%% % %%%%%%%%%%%%%%% %%% %%%%%%% %%% % %%% % %%%%%%%%% %
%%%%% %%%   %%%   %       % %%%     %%%%%%%   %   %   %%%   %%%%% %%% %%%%%%% %%% % %%%   %   %     %
%%%%% %%%%% %%%%% %%% %%%%%%%%%%%%% %%%%%%%%% %%% % %%%%% % %%%%% %%%%%%%%%%% %%% %%%%%%%%% % % %%%%%
%%%     %%%   %   %%% %%%     %%%%%       %   %%% % %%%   %       % %%% %     %%% %%%%%%%%% % % %%%%%
%%%%% %%%%%%% % %%%%%%%%% % %%%%%%%%% %%% % %%%%% % %%% %%%%%%% %%% %%% % %%%%%%% %%%%%%%%% % % %%%%%
% %%% %%% %%% %   %%%%%   %   %   %   %%%   %%%%%   %     % %%%   % %%%   %%%%%     % %%%%% % %     %
% %%% %%% %%%%%%% %%%%% %%%%% %%% % %%%%%%%%%%%%%%% %%%%% % %%%%% % %%%%% %%%%%%% % % %%%%%%% %%%%% %
%           %%%%%       %%%%%   %   %%% %%%%%   %%%   %     %%%       %%% %     % %           %%%   %
%%%%%%% %%%%%%%%%%%%%%%%%%%%%%% %%%%%%% %%%%% % %%%%% % %%% %%%%%%%%% %%% % %%% % %%% %%%%%%% %%% %%%
%%%%%   %%%%%   %%%%%%%%%%%%%%%     %   %%% % %!  %   % %%%   %%%%%%% %   % %     %   %%%%%%%   %   %
%%%%% %%%%%%% %%%%%%%%%%%%%%%%%%%%% %%% %%% % % %%% %%%%%%%%%%%%%%%%% % %%% %%%%%%%%%%%%%%%%%%% %%% %
%     %%%               %%%%%%%%%%% %%% %%%   % %%%   %%%     %%%%% % % %%%   %%%%%%%%%%%%%       % %
%%% %%%%% %%%%%%% %%% %%%%%%%%%%%%% %%% %%%%% % %%%%% %%% %%% %%%%% % %%%%%%% %%%%%%%%%%%%%%% %%%%% %
%%% %%%%% %%%%%%%   % %   %%%%%%%%% %     %%% % %   %     %%%   %       %     %   %%%%%%% %%%   %%% %
%%% %%%%%%%%%%%%%%% %%% % %%%%%%%%% %%% %%%%%%% % % %%%%%%%%%%% %%% %%% % % %%% % %%%%%%% %%%%% %%% %
%   %   %%%%%   %%%     % %%%%%     %%% %%%%%%%   % %%% %%%     %%% %%%   % %%% % %%%%%%%   %%% %%% %
% % %%% %%%%% % %%% %%%%% %%%%%%%%% %%% %%%%%%%%%%% %%% %%%%%%% %%%%%%%%% %%%%% % %%%%%%%%% %%% %%% %
% %  S%       %   % %%%%%         % %%%       %%%%%     %%%%%%%     %%%%% %%%   %   %%%       % %   %
% %%%%% % %%%%%%% %%%%%%%%% % %%% % %%% % %%%%%%%%% % % %%%%%%%%%%% %%%%%%%%% %%%%% %%% %%%%% %%% % %
%   %%% % %%%%% %   %%%   % % %%% %   % %       %%% % % %%%     %%% %%%%%%%%%   %%% %%%   %     % % %
%%% %%%%% %%%%% %%% %%% % %%% %%% %%% %%%%% %%% %%%%% %%%%% %%% %%% %%%%%%%%%%% %%% %%%%% %%%%% % % %
%%%       % %%%   %   % %     %%%     %%%%%   %       %%%   %%%   % % %%%%%     % % % %%% %%%%%   % %
%%%%%%%%%%% %%% %%%%% % %%%%% %%%%%%%%%%%%% %%%%%%% % %%%%% %%% %%% % %%%%% % %%% % % %%% %%%%% %%%%%
%   %%%               %   %%% %%%%%%%   %%% %%%%%   % %%%%%   % %%%   %%%   %   %     %%%   %%% %%%%%
%%% %%% %%%%%%%%%%%%%%%%% %%%%%%%%%%%%% %%%%%%%%% %%%%%%%%% %%% %%% %%%%% %%% % %%%%% %%% %%%%% %%%%%
%%%     %%% %%%%% %%%%%%%   %%%%%%%%%     %%%     %%%%% %   %%% %   %%%%% %%% % %%%   %%%     %     %
%%%%%%% %%% %%%%% %%%%%%% %%%%%%%%%%% %%% %%% %%% %%%%% % %%%%% % %%%%%%% %%%%% %%% %%%%%%%%% %%%%% %
%%%%%%%       %     %%%         %%%   %   %%% %%%       %   %%% % %%%   % %     %%%     %     % %   %
%%%%%%%%% %%% % %%% %%%%% %%% %%%%%%% % %%%%% %%% %%%%%%%%% %%% % %%% % % % %%%%%%%%%%% % %%%%% % %%%
%   %%%%% %%% % %%% %   %   % %%%%%%% % %%%%% %%%   %%%     %%%   %%% %   %   %%%%%%% % % %         %
% %%%%%%%%%%% % %%% % % %%%%% %%%%%%% % %%%%% %%%%% %%% %%%%%%%%% %%%%% %%%%% %%%%%%% % % %%%%% %%%%%
% %%% %%%%%   %   %   % %     % %%%   % %%%%%     %       %   %%% %%%%% %%%%%       %     %%%%% %%%%%
% %%% %%%%%%% %%% %%%%% % %%%%% %%% %%%%%%%%%%%%%%%%% %%% %%% %%%%%%%%% %%%%%%%%%%% % %%% %%%%% %%%%%
%     % %%%%% %   %%%     %%%%%   %     %%%%%%%%%%%%% %%%     % %%%   %         %%% % %%%   %%%   %%%
% %%% % %%%%% % %%%%%%%%%%%%%%% % % %%% %%%%%%%%%%%%%%%%%%%%% % %%%%% %%%%%%% %%%%% %%%%%%% %%%%%%%%%
%   %   %%%%% %   %%%%%         % % %%% %%%   %%%%%%%%%         %%%%%   %%%   %%%     %       %%%%%%%
% % %%% %%%%% %%% %%%%% %%% % %%% %%%%% %%% % %%%%%%%%%%%%% %%%%%%%%%%% %%% %%%%% %%% % %%%%%%%%%%%%%
% %   %   %   %%% % %   %%% % %%%   %%% %%% %   %%%%% %%%%%   %%%%%%%%%       %%% %%% %   %%%%%   %%%
%%%%% %%% % %%%%% % % %%%%%%% %%%%% %%% %%%%% %%%%%%% %%%%% %%%%%%%%%%%%%%%%% %%%%%%% %%%%%%%%% % %%%
%%%%% %%% % %   % %       %%%   %%%   % %%%   %%%     %%%   %%%%%%%%%%%%%%% % % %%%%% %%%%% %%% %   %
%%%%% %%%%% % % % % %%%%%%%%% % %%%%% % %%% % %%% %%% %%% %%%%%%%%%%%%%%%%% % % %%%%% %%%%% %%% % %%%
%%%         % %   % %%%%%%%%% % %%% %   %   % %%% %%%   % % %%%%%%%%%%%     % %   %%%       %%% % %%%
%%% %%%%%%%%% %%%%% %%%%%%%%% %%%%% %%% % % %%%%%%%%% % % % %%%%%%%%%%%%%%% % % % %%%%% %%%%%%% %%%%%
%     %%%     %%%     %%%     %%%     % % % %%%       % %     %%%%%%%%%%%%%     % %%%%%         %%% %
%%% %%%%% %%% %%%%% %%%%%%%%% %%% %%% % % %%%%% % %%%%%%%%% %%%%%%%%%%%%%%%%%%%%% %%%%%%%%%%% %%%%% %
%%% %%%   %%%   %%% %%%%%%%%% %     %     %%%%% %     %%%   %%%%%%%%%%%%%%%%%       %%%   %%%       %
%%% %%% % %%%%% %%% %%%%%%%%% %%%%% %%%%%%%%%%%%%%%%% %%% %%%%%%%%%%%%%%%%%%%%%%%%% %%% % %%%%%%% % %
%%%   % % %     %%% %%%%% %%% %%%       %%%%% %%%     %%%       %%%%%%%%%%% %%%%%%% %   %     %%% % %
%%%%% %%% %%%%%%%%% %%%%% %%% %%% %%%%%%%%%%% %%% %%%%%%%%% %%%%%%%%%%%%%%% %%%%%%%%% %%%%%%% %%% % %
%%%     %     %%% %   %   %   %%%   %%%         %   %%% %%% %%%%%%%%%%%%%%%         %   %%% % %   % %
%%%%%%% % %%% %%% % %%% % % %%%%%%%%%%% % %%%%% %%% %%% %%% %%%%%%%%%%%%%%% %%%%%%% %%% %%% % % %%%%%
%%%%%   % %   %     %   %   %%% %%%%%   %     %       %         %%%%%%%     %%%%%       %   %   %%%%%
%%%%% %%%%% %%% %%% % %%%%%%%%% %%%%% %%%%%%% %%%%% %%% %%% %%% %%%%%%% % % %%%%% %%%%%%% %%% %%%%%%%
%           %   %%% % %%%         %%% %%%%%%%   %%% %%% %%% %%%   %%%   % % %%%   %%%     %   %%%   %
%%% %%%%%%%%% %%%%%%% %%% %%% %%%%%%% %%%%%%%%% %%%%%%% %%% %%%%% %%%%% % % %%% %%%%%%%%% % %%%%% % %
%%% %%% %%%     %%%%% %   %%%       %   %%% %%%   %%%   %%% %%% %   %%% % % %%%   %%%%%   %     % % %
%%%%%%% %%%%%%% %%%%% % %%%%% %%% %%%%% %%% %%% %%%%%%% %%%%%%% % %%%%%%% %%%%%%% %%%%% %%%%%%% %%% %
%%%%%%%   %%% % %   %   %%%%% %%%       %%%     %%%%%%% %%%%%     %%%     %%% %%%   %%% %%%     %%% %
%%%%%%%%% %%% % % % %%% %%%%%%%%% %%% %%%%%%%%% %%%%%%% %%%%% %%% %%% %%%%%%% %%%%%%%%% %%% %%%%%%% %
%   %%%%%     %   % %%% %%%%%%%   %%% %%%%%%%%% %%%%%   %%% % %%% %%% %%%%%     %%%%%   %%% %       %
% % %%%%%%% %%%%%%% %%%%%%%%%%% %%%%%%%%%%%%%%% %%%%% %%%%% % %%%%%%% %%%%%%% % %%%%%%% %%% %%% %%% %
% % %%% %%%       %   %%%%%%% %     %%% %%%     %%%%% %%%%%     %%%%%     %%% %       % %%% %%% %   %
% %%%%% %%%%%%% %%%%% %%%%%%% %%% %%%%% %%% %%% %%%%% %%%%%%% %%%%%%% %%%%%%% %%%%% % % %%% %%% %%% %
% %%%         % %%% % %%%%%       %%%   %%% %%% %%%   % %%%%% %%% %%% %%%%%     %%% %   %%%   % %%% %
% %%% %%%%% % % %%% % %%%%%%% %%% %%% % %%% %%%%%%% %%% %%%%%%%%% %%% %%%%%%%%% %%% %%% %%%%% % %%% %
% %%% %     %   %%% % %%% %%% %%%     % %   % %%%%% %     %%%%%   %%%     %%%     %   % %%%   % %   %
% %%% % %%% %%% %%% % %%% %%% %%%%%%% %%% % % %%%%% % % % %%%%% % %%%%% %%%%%%%%%%%%% %%%%%%% % %%%%%
% %%% %   % %%%     %     %%%   %%%%% %%% %   %%%%% % % %     % %   %%% %%% %%%%%     %%%%%%% %     %
% %%% %%% %%%%%%%%%%%%%%% %%%%% %%%%%%%%% %%%%%%%%% %%% %%%%% %%%%% %%% %%% %%%%% %%%%%%%%%%% % %%% %
%     %%%   %%%%%         %%%%%   %%%%%%% %%%%%%% %     %%%   %%%%% %%%     %%%%%   %%%%%     % %%% %
% %%%%%%% % %%%%% %%%%%%%%%%%%%%% %%%%%%% %%%%%%% % %%%%%%%%% %%%%% %%%%%%% %%%%%%% %%%%%%% %%%%%%% %
% %%%%%%% %     %   %%%%%%%%% %%% %%%%%%% %%%%%     %%%%%%%%%   %%%     %%% %           %%% %%%%%   %
%%%%%%%%% %%% %%% %%%%%%%%%%% %%% %%%%%%% %%%%% %%%%%%%%%%%%% %%%%% %%% %%% %%% %%%%%%%%%%% %%%%% %%%
%%%   %%% %%% %   %%%%% %%%   %%% %%%%%%%   %   %%%%%%%%%%%   %%%   %%% %   %%% %               % %%%
%%% %%%%% %%% % %%%%%%% %%% % %%% %%%%%%%%% % %%%%%%%%%%%%% %%%%%%% %%% % % %%% % %%%%%%% %%%%% % %%%
% %       %%%   %%%%%     % %   %   %   %%%   %%%%%%%%%%%%%     %   %   % % %%% %     %%% %%%%%     %
% % %%%%%%%%% %%%%%%% %%% % %%% %%% % % %%%%%%%%%%%%%%%%%%%%%%% % %%% %%% %%%%% %%%%% %%%%%%%%%%% %%%
%     %%%%%   %%%%%   %%%   %%%       % %   %%%%%%%%%%%%%%%       %%%     %%%         %%%%%   %%% %%%
% %%%%%%%%%%% %%%%%%% %%% %%%%%%%%%%%%% % % %%%%%%%%%%%%%%% %%%%%%%%% %%% %%%%% %%%%%%%%%%% %%%%% %%%
% %%%%%%%%%%% %%%%%%% %%% %%%%%%%%%       % %%%%%%%%%%%         %%%   %%% %%%%%   %%%%%             %
%%%%%%%%%%%%%%%%%%%%%%%%%%%%%%%%%%%%%%%%%%%%%%%%%%%%%%%%%%%%%%%%%%%%%%%%%%%%%%%%%%%%%%%%%%%%%%%%%%%%%
