%%%%%%%%%%%%%%%%%%%%%%%%%%%%%%%%%%%%%%%%%%%%%%%%%%%%%%%%%%%%%%%%%%%%%%%%%%%%%%%%%%%%%%%%%%%%%%%%%%%%%
%%%     %%%     %%%   %     %%%     %%% %%%%%%%         %%% %%%%%   %%%%%     %%%%%%%%%%% %%%%%%% %%%
%%% %%%%%%%%% % %%% % % %%% %%% %%% %%% %%%%%%% %%%%% %%%%% %%%%%%% %%%%% % %%%%%%%%%%%%% %%%%%%% %%%
%     %%%%%%% % %%% %     %     %%%   %     %   %%%   %%%   %%%           % %%%     %%%           %%%
% %%% %%%%%%% % %%% %%%%%%%%% % %%%%% % %%% %%% %%%%%%%%% %%%%%%% %%%%%%%%% %%%%%%% %%%%%%% %%% %%%%%
% % %   %%%%% %     %%%%%%%%% % %%%%%   %%%       %%%%%           %%%                       %   %%%%%
% % %%% %%%%% %%%%% %%%%%%%%%%% %%%%%%% %%% %%%%%%%%%%% %%%%%%% %%%%%%%%%%%%%%%%%%%%%%%%%%%%% %%%%%%%
% % %%%       %%%%%   %     %%%     %%% %%% %%%%%%%   % %%%     %   %%%         %%%%%       %     %%%
% % %%%%% %%%%%%%%%%% %%%%% %%%%% %%%%% %%% %%%%%%%%% % %%% %%%%% % %%% %%%%%%% %%%%%%% %%% %%%%% %%%
% % %%%%% %%%%%               %%% %%%   %%% %%%   %%%   %%%   %%% %   % %%%       %%%%% %%%   %   %%%
% % %%%%%%%%%%%%%%% %%%%% %%% %%% %%% %%%%%%%%% % %%% %%%%%%% %%% %%% % %%% %%%%%%%%%%% %%%%%%% %%%%%
% % %%%   %%%   %%% %%%%% %%%   % %     %%%%%   % %%%   % %%%     %  !% %%% %%%%%%%     %%%%%     %%%
% % %%% % %%% % %%% %%%%%%%%% %%% % %%%%%%%%%%% %%%%%%% % %%%%%%%%% %%% %%% %%%%%%% %%%%%%%%% %%%%%%%
%   %%% %     % %   %%% %%%   %%% % %           %%%%%       %%%%%%%     %%%   %       %%%       %%%%%
% %%%%% %%%%%%% %%%%%%% %%%%% %%% %%% %%%%%%% %%%%%%%%% %%% %%%%%%%%%%%%%%%%% %%% %%% %%%%% %%%%%%%%%
% %%%   %%%%%%%   %       %%% % %   % %     % %%%%%%%%% %%% %         %%% %%% %%% %     %%%   %%%%%%%
% %%%%% %%%%%%%%% % %%% %%%%% % %%% % %%% %%% %%%%%%%%% %%% %%%%% %%%%%%% %%% %%%%% %%%%%%% %%%%%%%%%
% %%%%%   %%%%%%%   %   %%%     %   %     %%%   %%% %%% %%%       %%%%%%%       %%%         %%%     %
%%%%%%% %%%%%%%%%%%%% %%%%% %%%%% %%%%% %%%%%%% %%% %%%%%%%%%%% %%%%%%%%% %%%%% %%%%%%% %%%%%%% %%% %
%%%%%%%   %           %   % %%%%% %%%%% %%%   %             %%% %%%   %%% %%%   %%%%%%%   %%% % %   %
%%%%%%%%% %%% %%%%% %%% %%% %%%%% %%%%% %%% % %%%%% %%%%%%% %%%%%%% %%%%%%%%% % %%%%%%%%%%%%% % % %%%
%%%%%     %%% % %%% %%%     %     %%%%%   % %   %%% %%%%%   %%%%%%% %%%%%%%   %   % %%%%%%%   % %   %
%%%%% %%% %%% % %%%%%%% %%%%% % %%%%%%%%% % %%% %%% %%%%% %%%%%%%%% %%%%%%% %%%%% % %%%%%%% %%% %%% %
%%%%% %   %%%   % %%%%% %%%   % %%%%% %   % %%% % % %%% % %%%     %   %%%   %%%%%       %%% %%%   % %
%%%%% %%% %%%%% % %%%%%%%%% %%% %%%%% % %%% %%% % % %%% % %%%%% % %%% %%% % %%%%%%%%%%% %%% %%% %%% %
%%%   %%% %%%%%             %     %%% %   % %     %   %         % %%% %%% %     %%%%%%% %%%     %%% %
%%% % %%%%%%%%%%%%%%%%%%%%%%% %%%%%%% %%% % %%% %%%%% %%%%%%%%%%% %%% %%% %%%%% %%%%%%%%%%% %%%%%%% %
%%% %         %%%             %%%         % %%% %%%%% %%%%%%%%%%% %   %   %%%       %%%%%%% % %     %
%%%%% %%%%% %%%%%%%%%%% %%%%%%%%% %%%%%%%%% %%% %%%%% %%%%%%%%%%% %%% % %%%%% % %%%%%%%%%%% % % %%% %
%%%%% %%% %         %%% %%%%%%%%%   %%%     %%%   % %     %%%%%%% %%%     %   % %%%%%   %%%   %   % %
%%%%% %%% %%%%%%%%% %%%%%%%%%%%%%%% %%%%% %%%%%%% % %%% %%%%%%%%% %%%%% %%% %%% %%%%%%% %%% %%%%% % %
% %%% %   %%%   %%%             %   %%%%%     % % % %%%     %%%%%     % %   %%% %%%%%%%   % %%%%% % %
% %%% %%% %%% % %%%%%%%%%%% % %%% %%%%%%% %%% % % % %%%%%%% %%%%%%%%% %%% % %%%%%%%%%%%%% % %%%%% %%%
%     %%%     % %     %%%%% % %   %%% %%%   % %     %%%   %     %%%%%     % %%%%% %%% %%%     %%% %%%
% %%%%%%% %%%%% %%% %%%%%%% %%% %%%%% %%%%%%% %%% %%%%%%% %%%%% %%%%%%%%%%% %%%%% %%% %%%%%%%%%%% %%%
% %%%%%   %%%   %%% %%%   %     %             %%% %%%       %   %         % %           %%%%%%%%% %%%
% %%%%% %%%%%%% %%% %%% %%%%%%%%%%% % %%%%% %%%%% %%% %%%%% % %%% %%%%% %%% %%% %%%%%%% %%%%%%%%% %%%
%       %%%%%%% %%%       %%%       % %%%   %%%%%     %%%%% % %%%   % %   %     % %%%       %%%     %
%%%%%%%%%%%%%%% %%%%%%% % %%%%% %%%%% %%% %%%%%%%%%%%%%%%%% % %%%%% % %%% %%%%%%% %%% %%% %%%%% %%%%%
% %%%%%%%%%%%%%     %%% %       %%%   %%% %%%%%%%%%   %     % %   %   %%%     %%%     %%% %%%   %%%%%
% %%%%%%%%%%%%%%%%% %%%%%%%%% %%%%% %%%%%%%%%%%%%%% %%% %%%%% % % % %%%%% %%% %%% %%%%%%%%%%% %%%%%%%
%       %%%         %         %%%%%   % %%%%%%%%%%%   % %   % % % % %%%   %%%     %%% %%%%%   %%%   %
%%%%%%% %%%%%%% %%%%% %%%%%%%%%%%%%%% % %%%%%%%%%%% % % %%% % %%% % %%%%% %%%%%%%%%%% %%%%% %%%%%%% %
%%%     % %%%%%       % %%%%%%% %%% %   %%%%%   %%% % % %%% %   %     %%% %%%%%         %%% %%%     %
%%% %%% % %%%%%%%%%%%%% %%%%%%% %%% %%% %%%%% %%%%% % % %%% %%% % %%% %%%%%%%%% %%%%% %%%%% %%% %%%%%
%%%   %   %   %%% %     %%%%%   %%%     %%%     %%% %   %%%   % % %%% % %%%%%   %%%%% %%%%%     %%%%%
%%%%% %%%%% % %%% % %%% %%%%% %%%%% %%%%%%%%%%% %%% %%%%%%% %%% %%%%% % %%%%% % %%%%%%%%%%%%% % %%%%%
% %%% %%%   % %%%   %     %%% %%% %   %%%%%%%%%   % %       %%% %%%     %     %     %%%%%     % %%% %
% %%% %%% %%% %%% %%% %%%%%%% %%% %%% %%%%%%%%% %%% % %%%%%%%%% %%% %%% %%% %%%%% %%%%%%% %%%%% %%% %
% %         %       %   %         %     %%%%%%%       %     %   %   %%% %%% %%%   %%%     %     %   %
% % %%%%%%%%% %%%%%%%%% % %%%%% %%% %%%%%%%%%%% %%%%%%% %%% % %%% %%%%% %%% %%%%%%%%%%% %%%%% %%% %%%
%       %%%%% %%%%%     % %%%%% %   %%%%%%%%%       %%%   %   %     %%%       %%%%% %%%     % %   %%%
%%%%% %%%%%%% %%%%% %%%%% %%%%% % %%%%%%%%%%% %%%%% %%%%% %%% %%%%%%%%%%%%% %%%%%%% %%%%%%% % %%% %%%
%%%   %     % %%%%%     % %%% %   %%%   %%% % %%%   %   % %   %     %%%     %%%       %%%%% %     %%%
%%%%%%% %%% %%%%%%% %%% % %%% %%%%%%% %%%%% % %%%%% % % % %%%%% %%% %%%%%%% %%% % %%% %%%%% %%%%% %%%
%%%%%%% %%% %%%       %   %     %%%     %%%   %%%%%   % %   %%% %%%     %%%   % % %         %%%%% %%%
%%%%%%% %%% %%%%%%%%% %%%%%%% %%%%%%%%% %%%%%%%%%%% %%%%% % %%% %%%%%%% %%%%% %%% %%% %%%%% %%%%%%%%%
%%%%% % %   %%%   %%% %%% %%%         %   %%%%%     %%%%% %       %     % %%%     %%% %%%   % %%%%%%%
%%%%% % % %%%%% % %%% %%% %%% %%% %%% % %%%%%%%%% %%%%%%% %%%%%%%%% %%% % %%% %%%%%%%%%%% %%% %%%%%%%
%%%   % %       % %   %%% %%% %%% %     %       % %%%%%%% %%%   %%% %%%   %%% %%%   %%% % %     %%%%%
%%% %%% %%%%%%%%% %%% %%% %%%%%%% %%%%% % %%%%% %%%%%%%%% %%% % %%% %%% %%%%% %%% % %%% % %%%%% %%%%%
%   %%% %   %     %%%   %         %%%   % %%%   %%% %%%       % %   %%% %%%   %%% %     %   %%%     %
% %%%%% % %%% %%%%%%%%% % %%% %%% %%%%% % %%% %%%%% %%%%%%%%%%% % %%%%% %%%%%%%%%%% %%%%%%% %%% % %%%
%         %%%   %%%%%%%   %%% %%%   %%% % %   %       %%%%%%%   % %       %%%%%     %%%%%   %   % %%%
%%% %%%%% %%%%% %%%%%%%%%%%%%%%%% %%%%%%% %%% %%%%%%% %%%%%%%%%%% %%%%%%% %%%%%%% %%%%%%% %%%%% % %%%
%%% %%%   %%%%%       %     %%%   %%%%%   %%%         %           %%%%%   %%%%%%% %%% %%%   %%% %   %
%%% %%% %%%%%%% %%%%% %%% %%%%% %%%%%%% %%%%%%%%%%%%% %%%%% %%%%%%%%%%%%% %%%%%%% %%% %%%%% %%%%%%% %
%   %%% %%%%%%% %%%%% %%%       %%%%%   %%%         %     % %%%%%     %%%   %%%           %         %
% %%%%%%%%%%%%%%%%%%% %%% %%%%%%%%%%% %%%%%%%%% %%% %%%%% % %%%%%%% %%%%%%%%%%% %%%%%%% %%%%% %%%%%%%
%     %%%%%%%%%%%     %%% %%%%%%%   %       %%%   % %%% %   %       %%% %%%%%%% %       %%%%% %%%%%%%
%%% %%%%%%%%%%%%%%% %%%%%%%%%%%%%%% % %%%%% %%%%% %%%%% %%%%%%% %%%%%%% %%%%%%% % %%%%% %%%%% %%%%%%%
%%% %%%%%%%%%%%%%   %     %     %%%   %%%%%   %%% %%%%%     %%%                 % %%%     % % %%%%%%%
%%% %%%%%%%%%%%%% %%% %%% % %%% %%%%%%%%%%% % %%% %%%%% %%% %%% %%%%%%%%%%%%% %%% %%%%%%% % % %%%%%%%
%   %%%%%%%%%%%%%S%%% %%% % %%%   %%%%%   % % %%% %       % %%% %       %%%%%   %       %   % %%%%%%%
%%% %%%%%%%%%%%%%%%%% %%% % %%%%% %%%%% % % % %%% % %%% % %%%%% % % %%% %%%%%%% %%% %%% %%%%% %%%%%%%
%%% %%% %%%%%%% %%%   %%%   %%% %       %   % %%% % %%% %   %   % % %%% %%%     %%% %%%   %%%   %%%%%
%%% %%% %%%%%%% %%% %%%%%%%%%%% %%% %%% %%%%%%%%% % %%%%%%% % %%% % %%%%%%%%% %%%%% %%% % %%% %%%%%%%
%   %   % %%%%%     %%%%%%%%%%%     %%% %%%%%%%     %       % %%% %   %%%%%%%   %%% %%% %     %%%%%%%
% %%% % % %%%%% %%%%%%%%%%%%%%% %%%%%%%%%%%%%%%%%%% % %%%%%%% %%% %%% %%%%%%%%% %%%%%%% %%%%%%%%%%%%%
%     %   %%%   %   %%%%%     % %%%   %%%     %%%%% % %%%%%%% %   %%% %%%   %%%   %%%%%     %     %%%
%%%%%%% %%%%%%% % % %%%%% %%% % %%% % %%%%% % %%%%%%% %%%%%%% % %%%%%%%%% %%%%%%% %%%%%%%%% %%% %%%%%
%     % %%% %%%   %   % % %%%   %%% %   %%% %     %%%       %   %%% %%%%%     %%%     %%%%% %%%     %
% %%%%% %%% %%%%%%%%% % % %%%%% %%% %%% %%% % %%% %%%%% %%% %%% %%% %%%%%%% %%%%%%% %%%%%%% %%%%% %%%
% %%%   %%%           %   %%%%% %%% %%%     % %%% %%%%%   %   % %         % %%%%%%% %%%     %%%%%   %
% %%% %%%%%%%%% %%%%% %%% %%%%%%%%% %%%%%%% %%%%%%%%%%%%% %%% % % %%%%%%% % %%%%%%%%%%% %%%%%%%%%%% %
%   %     %%%   %%%%% %%%     %%%%%   %%%   %%%%%%%%%   % %%%     %%%       %%%   %%%   %%%   %%%   %
% %%%%% %%%%% %%%%%%%%%%%%%%% %%%%%%%%%%% % %%%%%%%%%%% % %%% %%%%%%% %%%%% %%% %%%%% %%%%% %%%%% % %
% %%%%% %%%%%           %%%%%       %%%   % % %%%%%%%%%   %%% %%%%%   %%%%% %%% %%%   %%%   %%%   % %
% %%%%% %%%%%%% %%% %%% %%%%%%%%%%% %%% %%% % %%%%%%%%%%%%%%% %%%%%%% %%%%%%%%% %%% %%%%% %%%%% % %%%
%   %%% %     % %%%   %   % %%%%%       %%% %   %%%%%%%%%%%   %%% %%% %   %%%     % %%%         % %%%
% % %%% % %%% %%%%% %%%%% % %%%%%%%%% %%%%% % %%%%%%%%%%%%%%%%%%% %%% % %%%%% %%% % %%% %%%%% %%%%%%%
% %   % %   % %%%%% %%%%% %   %%%%%   %%% %   %%%%%%%%%%%%%%%%%         %%%%% %%%   % % % %%%   %%%%%
% %%% % %%% % %%%%%%%%%%% %%% %%%%%%% %%% %%% %%%%%%%%%%%%%%%%% %%% %%%%%%%%% %%%%%%% % % %%%%% %%%%%
%   % %     % %%%%%%%     %%%     %%% %%%     %%%%%%%%%%%%%%%   %%% %%%%%   % %   %%%     %%%       %
%%% % %%%%%%% %%%%%%%%% %%%%% %%% %%% %%% %%%%%%%%%%%%%%%%%%%%% %%%%%%%%% % % %%% %%%%% %%%%% % %%% %
%%% % %%%             % %     %   %%% %%%   %   %   %%%%%%%%%%% %%%%%%%%% %           % %     % %%% %
%%% %%%%% %%% %%%%%%% % %%% %%% %%%%%%%%%%% % % % % %%%%%%%%%%%%%%%%%%%%%%%%%%% %%%%% %%% %%% %%%%% %
%   %%%%% %%% %%%%%%% % %%% %%% %%% %%%       %   % %   %%%%%%%%%%%%%%%%%%%%%   %%%       %%% %%%%% %
% % %%%%% %%%%%%%%%%% % %%%%%%% %%% %%% %%% %%% %%% % %%%%%%%%%%%%%%%%%%%%%%% %%%%%%%%%%% %%%%%%%%% %
% %         %%%         %%%%%%%         %%% %%% %%%   %%%%%%%%%%%%%%%%%%%%%%% %%%%%%%%%     %%%     %
%%%%%%%%%%%%%%%%%%%%%%%%%%%%%%%%%%%%%%%%%%%%%%%%%%%%%%%%%%%%%%%%%%%%%%%%%%%%%%%%%%%%%%%%%%%%%%%%%%%%%
