%%%%%%%%%%%%%%%%%%%%%%%%%%%%%%%%%%%%%%%%%%%%%%%%%%%%%%%%%%%%%%%%%%%%%%%%%%%%%%%%%%%%%%%%%%%%%%%%%%%%%
% %%%%%   %%%%%%% %%%%%%%               %%%%%%%%%%%%%     %%% %%%           %%%     %%%%%       %%%%%
% %%%%%%% %%%%%%% %%%%%%%%%%% %%%%%%%%% %%%%%%%%%%%%% %%% %%% %%%%% %%%%%%% %%%%% %%%%%%%%%%% % %%%%%
%       %   %%%%%   %%%%%%%%% %%%%%%%%%   %%%%%%%%%%% %%% %     %%%   %%%%%   %%% %%%%% %%%   % %%%%%
% %%% % % %%%%%%% %%%%%%%%%%%%%%%%%%%%%%% %%%%%%%%%%% %%% %%% %%%%%%% %%%%%%%%%%% %%%%% %%% %%%%%%%%%
% %%% %   %%% %%% %%% %%%%%           %%%     %%%%%     %     %%%         %%%%%             %%%%%%%%%
%%%%% %%% %%% %%% %%% %%%%% %%%%%%% %%%%%%% %%%%%%% %%% %%%%%%%%% % %%%%% %%%%%%%%% %%%%% %%%%%%%%%%%
%     %%%       %     %%%   %     % %%%%%%%     %%% %   %%%%%%%%% % %%%     %%%%%%% %%%%% %%%%%%%%%%%
% %%%%%%%%%%%%% % %%% %%%%% %%% %%% %%%%%%%%% %%%%%%% %%%%%%%%%%% %%%%%%%%%%%%%%%%% %%%%% %%%%%%%%%%%
%   %%%%%     %   %%% %%%%%   %   %   %%%%%%%   %%%%% %       %%%     %%%%%%%   %%%   %%%   %%%%%%% %
% % %%%%% %%% %%%%%%%%%%%%%%% % % %%% %%%%%%% % %%%%% % % %%% %%%%% %%%%%%%%% % %%%%% %%%%% %%%%%%% %
% % %     %%%     %%%%%     % % %   %   %%%%% %   %%%   %   %   %   %%% %%%   % %%% % %%%   % %%%   %
%%% % %%%%%%%%% % %%%%% %%% % % % % %%% %%%%% %%% %%%%%%%%% %%% % %%%%% %%% % %%%%% % %%% % % %%% %%%
%%%       %%%%% %   %%% % %   % % % %%%     % %%%       %%% %%%   %%%%% %%% % %%%     %   %   %%% %%%
%%% %%%%%%%%%%% %%% %%% % %%%%%%% %%%%%%%%% % %%%%% %%% %%% %%%%% %%%%% %%%%% %%% %%% % %%%%% %%% %%%
% % %%%%%%%     %       %   %%%%% %%% %     % %%%   %%%   %   %%%     %       %%% %%% % %%%   %   %%%
% % %%%%%%%%%%%%% % %%%%% %%%%%%% %%% % %%% %%%%% %%%%%%% % %%%%%%%%%%% % %%% %%%%%%%%% %%%%% %%% %%%
%   %     %       % %%%%%             % %%% %%%%%     %%%   %%% %%%     % %%%   %     %   %%%     %%%
% %%%%%%% % %%%%%%%%%%%%% %%%%%%%%% %%% %%%%%%%%%%% %%%%% %%%%% %%% %%%%% %%%%% % %%% %%% %%% %%% %%%
%   %%%   %         %%% % %%%%%%% %     % %%%%%%%   %%%   %%%     % %%% %     %   %%%     %%% %%% %%%
%%% %%% %%% %%%%%%% %%% % %%%%%%% %%%%%%% %%%%%%% %%%%%%%%%%%%% %%% %%% %%%%% %%% %%%%% %%%%%%%%%%%%%
%%%     %%% %%%     %   % %%% %%%     %     %%%   %%%%%%%%%     %%% %   %%%%% %   %%%%% %%%%%%%%%%%%%
%%% %%%%%%%%%%% %%%%% %%% %%% %%% %%% % %%% %%% % %%%%%%%%% % %%%%% % %%%%%%% %%% %%%%%%%%%%%%%%%%%%%
%   %           %     %%%   % %%% %%%   %%%   % % %%%%%%%   % %       %%% %%% %%% %   %%%%%%%       %
%%%%% %%%%%%% %%% %%% %%%%% % %%% %%%%% %%%%% % %%%%%%%%%%%%% % %%%%% %%% %%% %%% % % %%%%%%%%% %%% %
%   % %%% %   %%% %%%               %%% %%%%% % %%%%%%%%%%%%%   %%%   % %     %   % % %%%%%%%   %   %
% % % %%% % %%%%% %%%%%%% %%% %%%%%%%%%%%%%%% % %%%%%%%%%%%%%%%%%%% %%% % %%% %%% % % %%%%%%% %%% %%%
% %   %%%     %%%   %%%%% %%% %%%%%%%%%%% %       %%%%%%%   %%%%%       % %%% %%%   % %%%%%     %   %
% %%%%%%% %%% %%% %%%%%%% %%% %%%%%%%%%%% % %%%%%%%%%%%%% % %%%%%%%%% %%% %%%%%%%%%%% %%%%% %%% % %%%
%   %     %%% %%% %%%     %%%     % %%%     %%%%%%% %%%   %     %%% % %%%   %%%%%%%     %   % % % %%%
% % %%%%% %%% %%%%%%%%% %%%%%%%%% % %%%%%%%%%%%%%%% %%% % %%% %%%%% % %%%%% %%%%%%%%%%% % %%% % %%%%%
% %   %%% %%% %%%%%%%%% %%% %%%%%     %%%%%%%       %%% % %%% %         %%%       %%%   %   % %     %
% %%% %%%%%%%%%%%%%%%%%%%%% %%%%% %%%%%%%%%%% % %%%%%%% %%%%%%% %%%%%%%%%%%%% %%%%%%%%%%%%% % %%% %%%
% %   % %%%%%%%   %%%%%%%%% %%%%% %%%%%       % %%%%%   %%% %%%   %%%%%%%%%%%       %%%%%     % % %%%
%%% % % %%%%%%% %%%%%%%%%%% %%%%% %%%%%%%%%%% %%%%%%%%% %%% %%%%% %%%%%%%%%%%%%%% %%%%%%% %%% % % %%%
%   %   %   %%% %%%%%%%%%   %%%       %%%%%%%   %       %%%   %%% %         % %%% %%%     %%% % %   %
% %%%%%%% % %%% %%%%%%%%%%% %%% %%% %%%%%%%%%%% % %%% %%%%% %%%%% % %%% %%% % %%% %%%%% %%%%% % %%% %
% %%%%%   %       %%%%%%%%%   % %%% %%%   %%%%%     %   %%%     % % %%% %%%   %%%   %%%   %%%   %   %
% %%%%% %%% %%%%% %%%%%%%%% %%% %%%%%%%%% %%%%%%% %%%%% %%% %%% % %%%%% %%%%% %%% %%%%%%% %%%%% % % %
%     % %%% %%%   % %%%%%         %%% %%% %%% %%% %     %   %%%   %%%   %%%%%   %   %%% % %%%%% % % %
% %%% % %%% %%% %%% %%%%%%%%%%%%% %%% %%% %%% %%%%% %%%%% %%%%% %%%%% %%%%%%%%% %%% %%% % %%%%%%% % %
% %%%   %   %   %   %%%%%%%   %   %%%           %   %%%%% %%%         %%%     %   % %         %   % %
% %%%%%%% %%%%% % %%%%%%%%% % %%%%%%%%% %%%%% % % % %%%%% %%% %%%%%%% %%%%%%% %%% % % %%% %%% % %%%%%
%     %%%   %%%   %%%%%%%%% %   %%% %%%   % % %   % %   % %%%   %%%   %%%%%%%   % %   %%% %%% %     %
% %%%%%%%%% %%%%%%%%%%%%%%% %%% %%% %%%%% % % % %%%%% % % %%%%%%%%%%% %%%%%%%%% % %%%%%%%%%%% %%%%% %
% %%%%%       %%%%%         %   %%%   %%% % % % %%%%% %   % %%%%%%%%% %%% %     %   %%%     % %   % %
% %%%%% %%%%%%%%%%% %%%%% %%% % %%% %%%%% % % %%%%%%% %%% % %%%%%%%%%%%%% % % %%%%% %%%%% % %%% % % %
% %%%%% %%%%%     % % %%% %   % %           %         %%%   %       %%%   % % %%%%% %%%%% % %%% % % %
% %%%%% %%%%% % %%% % %%%%% %%%%% %%%%%%%%%%%%% %%%%%%%%%%% %%% %%%%%%%%% % % %%%%% %%%%% % %%% % % %
% %%%   %   % %       %%%%%     %         %   % %%%%%%%%%%% %%% %%%%%     % %       %     %     % % %
%%%%% % % % % %%%%%%%%%%%%%%%%% %%%%% %%%%% % %%%%%%%%%%%%% %%% %%%%%%% %%% %%%%% %%% % %%% %%%%% % %
%%%   %   % % %%% %%%%%%%%%%%   %     %%%   %     %%%     %   %     %%%     %%%%%   % % %%% %%%%%   %
%%% %%%%%%% % %%% %%%%%%%%%%% %%% %%%%%%% % %%%%% %%%%%%% %%% % % %%%%% %%%%%%%%% %%% %%%%%%%%%%%%% %
% %   %   %   %         %%%%%     %S  %%% % %%% % % %%%%%   % % % %%%   % %   %%% %%% %%%%%%%   %%% %
% %%% % % %%%%%%%%% % %%%%%%%%%%%%%%% %%% %%%%% % % %%%%% %%% % % %%%%% % % % %%%%%%% %%%%%%% %%%%%%%
%   % % %         % % %%%%%%%%% %%%%% % %   %       %%%%%     % % %%%%%   % %   %%%   %%%%%       %%%
%%% % % %%%%%%%%% % %%%%%%%%%%% %%%%% % % % %%%%%%% %%%%% %%%%% %%%%%%% %%% %%% %%% % %%%%% %%%%% %%%
%%% %   %%%     %   %%%     %%% %%%%% %   %     %   %           %%%%%   %   %%%     % %%%%% %   %   %
%%% %%%%%%% %%%%%%% %%%%% % %%% %%%%% %%%%%%%%% %%% %%%%%%%%% %%%%%%%%%%% %%%%%%%%%%% %%%%% % %%% %%%
%     %%%     %%%%%   %%% %   %   %%%           %%% %%%%%%%   %%%%%%%     %     %     %       %%%   %
%%%%% %%% %%% %%%%%%% %%% %%% % %%%%%%%%%%%%%%%%%%% %%%%%%% %%%%%%%%% %%% %%% % % %%%%% %%%%% %%%%% %
%%%%%     % %     %%%   % %%%   %%% %%% %%% %%% %   %%%%%     %%%%%   %%% %%% %   %%%%% %%%%%   %   %
%%%%% %%%%% % %%%%%%%%% % %%%%% %%% %%% %%% %%% % %%%%%%%%% %%%%%%% %%%%%%%%% %%%%%%%%% %%%%%%% % %%%
%%%%%   %%% %       %%%   %%%%%         %%%       %%%   %%% %%%%%   %   %%%       %%%       %%% % %%%
%%%%% %%%%% %%%%%%% %%%%% %%%%%%%%%%%%%%%%% %%%%%%%%% %%%%%%%%%%%%% %%% %%% %%%%%%%%%%%%%%% %%%%% %%%
%%%   %%%   %%%   %   %%%   % %%%%%         % %%%%%  !%%%%%%% %%%   %%%       %%%%% %%%       %%%   %
%%% %%%%% %%%%% % %%% %%%%% % %%%%% %%%%%%%%% %%%%%%% %%%%%%% %%% %%%%% %%%%%%%%%%% %%% %%%%%%%%% % %
%%% % %%%       % %%%             %   %%%%%   %%%     % %%%%%     %   % % %%%%%   %   %   %       % %
%%% % %%%%%%% %%%%%%% %%% %%% %%%%%%% %%%%% %%%%%%% % % %%%%% %%% %%% % % %%%%% % % % % %%% %%% %%% %
% %           %%%%%%% %%% %%% %%%%%%%     % %%%%%%% %   %%%   %%% %%%     %%%   % % %   %%%   % %%% %
% %%%%%%%%%%% %%%%%%%%%%%%%%%%%%%%%%%%%%% % %%%%%%% %%% %%% % %%%%%%%%%%%%%%% % % % %%%%%%% % %%%%% %
%   %       % %   %%%%% %%%   %%%%%     %   %%%%%     % %%% % %%%%%           % % % %%%%%%% % %%%   %
% %%% %%% %%% %%% %%%%% %%% % %%%%% %%%%%%% %%%%% %%% %%%%%%% %%%%%%% %%%%%%% % %%% %%%%%%%%% %%% %%%
%     %   %   %     %%%   % %     %         % %   %   %%% %%% %%%%%%%   % %%% %   % %%% %%%%% %%% %%%
% %%%%% %%% %%% %%% %%%%% % %%% % % %%%%%%%%% % %%% %%%%% %%% %%%%%%%%% % %%%%%%% % %%% %%%%% %%% %%%
%   %%% %%%     %   % %%% % %%% %   % %%%       %%% %%%       %%%%%%%   %   %%% % %   %       %%%   %
% %%%%% %%%%%%%%% %%% %%% % %%%%%%%%% %%% %%%%%%%%% %%% %%% %%%%%%%%%%% %%% %%% % % %%% %%% %%%%%%% %
% %             %     %%%     %%% %%%     %%%%%%%%% %%% %   %%%%%%%%%%%     %%% %   %%% %   %%%%%%% %
%%% %%% %%% %%% %%% %%%%% %%%%%%% %%%%%%%%%%%%%%%%% %%%%% %%%%%%%%%%%%%%%%% %%% %%% %%% % %%%%%%%%%%%
%%%   % %%% %%% %%% %%%   %%%%%       %%%     %         %       %%%%% %%%%% %   %%% %   % %   %%%%%%%
%%% % %%%%%%%%% %%% %%% %%%%%%%%% %%% %%% %%% %%% %%%%% %%% % %%%%%%% %%%%% % %%%%%%% %%% % %%%%%%%%%
%%% %     %%%   %%%   %     %%%   % %     %%% %%%     %     % %       %%%     %%% %%% %     %%% %%% %
%%% %%%%% %%% %%%%%%% %%%%% %%% %%% %%%%%%%%% %%%%%%% %%%%%%% % %%%%% %%% %%%%%%% %%% %%%%% %%% %%% %
%   %%% % %%%   %%%%% %%%       %   %%%%%%%     %%%%%   %%%%% % %%%%% %%% %%%%%       %%%   %%% %%% %
%%% %%% % %%%%%%%%%%% %%%%%%%%%%% %%%%%%%%%%%%% %%%%%%% %%%%% % %%%%% %%% %%%%% % %%%%%%%%% %%% %%% %
%%% %   %     %%%%%%% % %%%%%         %%%%%%%   %%%%%%% %     % % %   %       % % %%%%% %%% %   %   %
%%% % % %%%%% %%%%%%% % %%%%% %%% % %%%%%%%%% %%%%%%%%% %%%%%%% % % %%% %%%%% % %%%%%%% %%% % %%% % %
%   % % %%%     %%%   %   %%% %%% %     % %%%     %%%       %%%   % %     %%% % %%%%%       %     % %
% %%% % %%% % %%%%% %%%%% %%%%%%%%%%% % % %%%%%%% %%%%% %%% %%%%% % % %%% %%%%% %%%%%%%%% %%% %%%%% %
%     % %%% % %%%%% %       %%%       %       %%%   %%% %   %     %   %%% % %%%   %%%%%%%   %   %%% %
%%% %%% %%% %%%%%%% % %%%%% %%% % %%%%%%% %%%%%%% %%%%%%% %%% %%% %%%%%%% % %%%%% %%%%%%%%% %%%%%%% %
%%% %%% %%% %%%%% %   %%%%%   % % %%%%%   %       %%% %%%     %%% %%%%%       %   %       % %%%     %
%%%%%%%%%%% %%%%% %%% %%%%%%% % %%%%%%%%%%% %%%%% %%% %%%%%%% %%%%%%%%%%%%% %%% %%% %%% %%% %%% %%%%%
%%%%%%%%%%%   %%%   % %%%%%%%   %%%   %%%     %%% %%%     %%% % %%% %%%%%%% %   %%% %%%         %%%%%
%%%%%%%%%%% % %%%%% % %%%%%%%%%%%%% % %%% %%%%%%%%%%%%% % %%% % %%% %%%%%%%%% %%%%%%%%% %%%%%%% %%%%%
%%%%%%%%%   %   %%%   %%% %%%%%%%   %   % % %%% %%%     %   %       %%%%%     %%%%%%%%% %%%%%   %%%%%
%%%%%%%%%%% %%% %%% %%%%% %%%%%%% %%% %%% % %%% %%% % %%%%% %%% %%%%%%%%% %%% %%%%%%%%% %%%%%%%%%%%%%
%%%%%%% %%% %%%   % %%%%%         %%%       %       % %%%%%   % %%%%%     %     %%%     %   %%%%%%%%%
%%%%%%% %%% %%%%%%% %%%%%%%%%%% %%%%%%% %%% % %%% %%% %%%%%%% %%%%%%%%%%% %%%%%%%%%%% %%%%% %%%%%%%%%
%%%%%%%               %%%%%%%%%   %%%%% %%%   %%% %%%     %%%             %%%%%%%%%%%             %%%
%%%%%%%%%%%%%%%%%%%%%%%%%%%%%%%%%%%%%%%%%%%%%%%%%%%%%%%%%%%%%%%%%%%%%%%%%%%%%%%%%%%%%%%%%%%%%%%%%%%%%
