%%%%%%%%%%%%%%%%%%%%%%%%%%%%%%%%%%%%%%%%%%%%%%%%%%%%%%%%%%%%%%%%%%%%%%%%%%%%%%%%%%%%%%%%%%%%%%%%%%%%%
%%%%%%%%% %%%%%   %%%%%%%%%%%%%%% %%%%%       %%%     %   %%%%%       %%%             %%% %%% %%%%%%%
%%%%%%%%% %%%%% % %%%%%%%%%%%%%%% %%%%% %%% %%%%% %%% %%% %%%%% %%% %%%%%%%%%%%%%%% %%%%% %%% %%%%%%%
%%%%%%%%%   %%% % %%%%%%%%%%%%%%%   %%%   %   %%%   %     %     %%% %%%%%%%%%%%%%%%           %%%%%%%
%%%%%%%%% % %%%%% %%%%%%%%%%%%%%% % %%%%%%%%% %%%%% %%%%% %%%%%%%%% %%%%%%%%%%%%%%% %%%%% %%%%%%%%%%%
%%%%%%%%% % %%%   %%%%%   %%%%%   % %%%%%%%       %   %         %   % %%%   %%%%%%% %%%%%   %%%%%%%%%
%%%%%%%%% %%%%% %%%%%%% %%%%%%%%% %%%%%%%%% %%%%% %%% %%%%%%%%% % % % %%% %%%%%%%%% %%%%%%% %%%%%%%%%
% %%%%%   %%%           %%%%%%%%%       %%%   %%% %%% %%%%%%%     %   %%% %%%   %%%   %%%     %%%%% %
% %%%%% % %%%%% %%% %%% %%%%%%%%%%% %%% %%% % %%% %%% %%%%%%% %%%%%%%%%%% %%%%% %%%%%%%%% %%% %%%%% %
%       % %%%%% %%% %%%       %%%   %   %   % % %     %   %%%   %%%%%%%     %%% %%%%%%%     % %%%%% %
% %%% %%%%%%%%%%%%%%%%%%%%% % %%% %%%%% %%%%% % %%%%%%% %%%%%%% %%%%%%%%% %%%%% %%%%%%%%% % %%%%%%% %
% %   %%%%%%%%%%% %%%       % %   % %%%       %   %     %%%     %   %     %%%%% %%%%%%%%% % %%%%%   %
% %%%%%%%%%%%%%%% %%%%% % %%% %%% % %%%%%%%%%%%%% % %%% %%% %%%%% % % % %%%%%%% %%%%%%%%%%% %%%%%%% %
%           %     %%%%% % %%%     % %   %%%   %%% % % % %%%   %   % % %   %%%%%         %%% %%% %%% %
% %%%%%%%%% % %%% %%%%% %%%%%%%%%%% % % %%% %%%%% % % % %%% %%% %%% % %%% %%%%% % %%% %%%%% %%% %%% %
%   %%%     % % % %%%     %%%   %%%   %   %   %     % %     %%% %%%   %%% %%%   % %   %%%   %   %%% %
% %%%%% %%%%% % % %%%%%%% %%% %%%%%%% %%% % % % %%%%% %%%%%%%%% %%%%%%%%% %%%%%%% %%% %%% % % %%%%% %
% %%%           %         %%% %   %%%   %   %   %         %%% % %   %%%%% %%%     %%% %   % %     % %
%%%%%%% %%%%%%% % % %%% %%%%% % % %%%%% %%% %%% % %%% %%%%%%% % % %%%%%%% %%% %%%%%%% %%% % %%% % % %
%%%%%%% %%%%% % % % %%% %%%%%   % %%%   %%% %%%   %%% %%%         %%%         %%%   %   % % %%% % % %
%%%%%%%%%%%%% % % %%%%%%%%%%% %%% %%% %%%%%%%%%%% %%%%%%% %%%%%%%%%%% %%% %%%%%%% % %%% % % %%% % % %
%%%%%%%%%       %   %%%%%   % %%%   % %   %%%       %%%         %%%     % %%%     % %   % %   % %   %
%%%%%%%%%%% %%%%%%% %%%%% %%% %%% %%% % % %%% %%%%%%%%% %%%%%%% %%%%% % %%%%%%% %%% % %%% %%% % %%% %
%%%%%   %%%   % %%% %%%       %%%   % % % %%%   %       %%%%%%% %%%%% % %%%%%%% %%%   %   %     %   %
%%%%% % %%%%% % %%% %%%%% %%%%%%%%% % % %%%%%%%%% %%%%%%%%%%%%% %%%%%%% %%%%%%%%%%% %%% %%% %%%%% %%%
%   % %         % % %%%%% %%%%%%%%%     %%% %     %%% %%%       %%%     %%% %%%%%   %   %%% %%%     %
% % % %%%%%%%%% % % %%%%% %%%%%%%%%%% %%%%% % %%%%%%% %%%%%%%%%%%%%%% %%%%% %%%%% %%%%% %%%%%%%%%%% %
% %   % %%%%%%%   % %     %%%%%%%%%%% %%%     %         %%%         % %%%   %%%   %%%%% % %%%%%%%%% %
% %%%%% %%%%%%%%%%% %%%%%%%%%%%%%%%%%%%%% %%%%%%%%% %%%%%%% %%% %%% % %%%%% %%%%% %%%%% % %%%%%%%%% %
% %%%!      %       %         %%%%% %%%%% %%%       %%%%%   %%% %%%   %%%%%   %%% %     %   %%%%% % %
% %%%%% % %%% %%% %%% %%%%% %%%%%%% %%%%% %%%%% %%%%%%%%%%% %%%%%%% %%%%%%% %%%%% %%% % %%% %%%%% % %
% %     % %%% %%% %   %%% %     %%%         %%%   %%%%% %%% % %%%   %%%%%%% %%%   %%% % %%% %%%   % %
% % %%%%% %%% %%%%% %%%%% %%%%% %%% %%%%%%%%%%%%% %%%%% %%% % %%% %%%%%%%%% %%%%% %%% %%%%% %%% %%% %
%   %%%     % %%%%% %%%     %%%     %%%%%%%%%%%       %     %   %     %%%     %%% %   %%%%%     %%% %
% %%%%% %%% % %%%%% %%%%% %%%%%%%%%%%%%%%%%%%%% % %%%%% %%%%% %%%%% %%%%%%% %%%%% % %%%%%%%%%%% %%% %
% %%%   %%% % %%%   %     %%%%%%% %%%       %%% % %     %%%%% %%% % %%%     %%%     %%%%%       %%% %
% %%% %%%%%%% %%% %%% %%%%%%%%%%% %%%%% % %%%%% %%% %%% %%%%% %%% % %%% %%%%%%%%%%%%%%%%% %%% %%%%% %
% %%% %       %   %%%       %%%     %%% % %     %%% %%%   %%%       %   %%%%%%%%%%%     % %   %%%   %
%%%%%%% %%%%%%% %%%%% %%% %%%%% %%% %%%%% % %%% %%% %%% %%%%% %%%%% % %%%%%%%%%%%%% %%% % %%%%%%% %%%
%%%%%   %%%     %%%%% %   %%%   %%% %%%%% %   %   %   % %%%     %%%   %%%%%%%%%     %     %   %%%   %
%%%%% %%%%% %%%%%%%%%%% %%%%% %%%%% %%%%% % %%% %%% % %%%%%%%%%%%%% %%%%%%%%%%%%% %%%%% %%% % %%%%% %
%     %%% % %%%     %%% %%%   %%%%%   %%%   %   %%% % %%%%%%%%%%%   %%%%%%%%%%%%% %%%%% %%% %       %
%%% %%%%% % %%%%% % %%% %%% % %%%%%%%%%%%%% % % %%%%% %%%%%%%%%%%%%%%%%%%%%%%%%%% %%%%%%%%% %%%%%%%%%
%%%   %%% %   %%% % %       %   %         % % % %     %     %%% %%%%%%%   %%% %%%         %     %%% %
%%%%% %%% %%% %%%%% % %%%%% %%% % %%%%% % %%% %%% %%%%% %%% %%% %%%%%%% %%%%% %%% %%%%% %%%%%%% %%% %
%%%%% %%% %%% % %%%     %%% %%%       % %     %%%   %%% % %         %%%       % % %%%%%   %%%%% %   %
%%%%% %%% %%% % %%%%% %%%%% %%%%%%% %%% %%%%% %%%%% %%% % %%%%%%%%% %%% %%%%% % % %%%%%%% %%%%% % % %
%%%%% %     % % %%%%% %%%%%   %%%%% %%% %%%%% %%%%%   % %   %%% %%%   % %     % %   %   %     % % % %
%%%%% % %%% % % %%%%% %%%%%%%%%%%%% %%% %%%%% %%%%% %%% %%% %%% %%%%% % % %%%%% %%% % %%% %%% % % %%%
%%%%%   % %   %           %%%%%   %   %   %   %     %%%   %       %%%   % %%%         %%% %%% %   %%%
%%%%% %%% %%%%%%%%% %%% %%%%%%% % %%% %%% %%% % %%% %%%%% %%%%% %%%%%%%%% %%%%%%% %%% %%% %%%%%%% %%%
%%%   %%%   % %%%%% %%% %%% %%% % %   %%% %%% % %   %%% % %%%%% %%%%%%%%%       % %%%   %   %%%   %%%
%%%%% %%% % % %%%%% %%% %%% %%% % % %%%%% %%%%% %%%%%%% % %%%%% %%%%%%%%%%%%%%% %%%%%%% %%% %%% %%%%%
%%%%%     %       % %%% %%% %   %   %%%     %%%   %%%%%     %%%     %%%   %%% %     %%% %%%   %   % %
%%%%% %%%%% %%%%% %%%%%%%%% % %%% %%%%% % %%%%% % %%%%%%%%% %%%%% %%%%% %%%%% %%%%% %%%%%%%%% %%% % %
%%%%% %%%%% %%%%%       %   % %%%   %%% % %%%   %   %%%%%%% %%%%%       %%%%%   %%%   %%%%%%%       %
%%%%%%%%%%% %%%%%%%%%%% %%% % %%%%%%%%%%% %%%%% %%% %%%%%%% %%%%% %%% %%%%%%% % %%% %%%%%%%%%%% %%%%%
%%%%%%%%%%%     %%%   %   %     %%%%%     % %%% %%%         %%%   %%% %%%%%%% % %%%   % %%%%%%% %%%%%
%%%%%%%%%%% %%% %%% %%%%% % %%%%%%%%%%% % % %%%%%%%%%%%%%%%%%%% %%%%% %%%%%%% %%%%%%% % %%%%%%% %%%%%
%%%%%%%%%%% %%% %%%   %   %   %%%   %   %   %%%%%%%%%%%%%%%     %   %   %%%   %%% %%% %   %%%   %%%%%
%%%%%%%%%%% %%%%%%%%% % %%%%%%%%% % % %%%%% %%%%%%%%%%%%%%% %%%%% % % %%%%%%% %%% %%% %%% %%% %%%%%%%
%%%%%%%%%     %%%     %   %%%%%   %   %%% % %%%%%%%%%%% %%% %     %   %%%     %%% %%% %%%   % %   %%%
%%%%%%%%%%%%%%%%% %%% %%% %%%%%%% %%%%%%% % %%%%%%%%%%% %%%%% % %%% %%%%% %%% %%% %%% %%%%% % % %%%%%
%%%%%%%%%%%%%%%   % %   %         % %%%     %%%%%%%     %%%   % %%% %%%   %   %%%       %%%   % %%%%%
%%%%%%%%%%%%%%% %%% %%% %%%%%%%%%%% %%% %%%%%%%%%%% %%%%%%% %%% %%%%%%% % % %%%%%%% %%%%%%%%% % %%%%%
%   %%%         %%%     % %%% %       % %%% %%%%%   %%%%%   %%% %%%%%   % % %       %%%%%%%%% %     %
%%% %%%%% %%%%%%%%%%%%% % %%% % %%% %%% %%% %%%%%%% %%%%% % %%%%%%%%% %%% % % %%%%%%%%%%%%%%% %%% % %
%%%       %%%%%%% %%%%%   %     %%%     % %     %%% %%%   % %%%%%   %   % % %   %           %     % %
%%%%% %%%%%%%%%%% %%%%% %%% %%%%%%%%%%%%% % %%% %%% %%% % %%%%%%% % %%%%% % %%% % %%%%% %%% % %%% %%%
%%%%% %%%%%%%%%   %%%%% %%% %%%   %%%       %   %%% %   %     %%% %       % %%% % %%%%%   %   %%% %%%
%%%%% %%%%%%%%% % %%%%%%%%% %%%%% %%% %%%%%%% % %%% % %%%%% %%%%% %%%%%%% %%%%% %%%%%%%%%%% %%%%%%%%%
%%%   %%%%%%%   %     %%%         %%% %%%%%%% % %%%     %   %%%   %%% %%% %%%   %%%%%%%%%%% %%%%%%%%%
%%% %%%%%%%%% %%% %%%%%%%%%%% %%%%%%%%%%%%%%% %%%%%%%%% % %%%%% %%%%% %%% %%%%% %%%%%%%%%%%%%%%%%%%%%
%%% %%%       %%% %%%%%%%%%   %%%%% %%%     %     %%%   %       %%%     %   %%%   %%%%%     %%%%%%% %
%%% %%% %%% %%%%% %%%%%%%%%%% %%%%% %%% % %%% % %%%%%%%%%%%%%%% %%%%%%% %%% %%% %%%%%%% %%% %%%%%%% %
%       %%%   %         %%%%%     %     % %   % %%%       %%%%%     %%% %   %%% %%%%%   %%%         %
% %%%%%%%%%%% %%%%%%%%%%%%%%%%%%% % %%%%% % %%% %%% %%%%% %%%%% %%% %%% % %%%%% %%%%% %%%%%%% %%% %%%
%   % %%% %%%     %%%%%%%%%%%%% % % % %%%   %       %%%%% % %%% %%% %%%   %%% %   %%%   % %%% %%% %%%
%%% % %%% %%%%%%% %%%%%%%%%%%%% % % % %%%%%%% %%%%%%%%%%% % %%%%%%% %%% %%%%% %%% %%%%% % %%% %%%%%%%
%%% %       %       %%%%%%%%%     %   %   %%%   %%%%%     %   %%%   %     %%%   % %   %     %   %%%%%
%%% %%% %%% % %%%%% %%%%%%%%%%% %%%%% %%% %%%%% %%%%%%% %%%%% %%%%% %%% %%%%%%% % % % % %%% %%% %%%%%
%%% %%% %%% % %   % %%%%%%%%%%%   %%% %%% %%%%% %   %%% %%%     %%% %%% %%%%%%% %   %   %%% %%%     %
%%% %%% %%% % % %%% %%%%%%%%%%%%% %%% %%% %%%%% % %%%%% %%% %%% %%% %%%%%%%%%%% %%%%%%%%%%%%%%% % %%%
%       %%% % % %%% %%%%%%%     % %%%         % %     % %%% %%% %%%       %%%%%           %   % % %%%
% %%%%% %%%%% % %%% %%%%%%% %%% % %%%%% %%% %%% % %%% % %%% %%% %%% %%% %%%%%%% % %%%%% %%% % % % %%%
%   %%% %%%   %         %%%   % % %   % %%% %%% % %%% %     %   %%%   %         % %%%   %%% %   %   %
%%% %%%%%%% %%%%% %%% %%%%%%% %%% % % %%%%% %%% %%%%% %%%%%%%%% %%%%%%% %%%%% %%%%%%% %%%%% %%%%%%% %
% %   %%% %     % %%% %%% %%% %%%   %   %%%   % %%%   %     %%% %%%%%%%   %%%     %   %%%%% %S%%%   %
% %%% %%% %%%%% % %%%%%%% %%% %%%%%%%%% %%% %%% %%% % % %%%%%%% %%%%%%% %%%%% %%% % %%%%%%% % %%% %%%
% %%%     %%%%% %   %%% %       %%% %%% %   %%% %   %   %   %   %   %%% %%%%% %%% % %%%   %   %%% %%%
% %%% %%%%%%%%% %%% %%% % %%%%% %%% %%% % %%%%% %%% % %%% % % %%% %%%%%%%%%%%%%%% %%%%% % %%%%%%%%%%%
%     %%%%%%%%% %%% %%%   % %%% %       % %%%     % % %%% %       %%%%%%%%%%%%%   %%%   % %%%%%%%%%%%
% %%% %%%%%%%%% %%%%%%%%% % %%% % %%%%%%%%%%%%%%% % % %%% %%%%%%% %%%%%%%%%%%%%%% %%% % %%%%%%%%%%%%%
% %%% %%%   %%%       %%%   %%% % %   %%%         % % %     %%%   %%%%% %%%           % %%%%%%%%%%%%%
%%%%% %%% %%%%% %%% % %%%%% %%% % % % %%% %%% %%%%% %%% %%% %%%%%%%%%%% %%%%% % %%%%% %%%%%%%%%%%%%%%
%%%%%     %%%   %%% % %%% % % %     % %   %%% %%%       %%%   %%%%%         % % %%%   %%%%%%%%%%%%%%%
%%%%%%% %%%%% %%%%% %%%%% % % %%%%%%% % % %%% %%% %%% %%%%%%% %%%%% %%% %%% % %%%%%%% %%%%%%%%%%%%%%%
%   %%% %%%   %%% %         % %%%     % % %%% %%% %%% %%%   % %   % %%% %%%   %%% %%%   %%%%%%%%%%%%%
% %%%%% %%% %%%%% % %%% %%% % %%% %%% %%% %%%%%%%%%%%%%%% % % % % %%%%% %%%%% %%% %%% %%%%%%%%%%%%%%%
%       %%% %%%     %%% %%%   %%% %%%       %%%%%%%%%%%   %     %       %         %%% %%%%%%%%%%%%%%%
%%%%%%%%%%%%%%%%%%%%%%%%%%%%%%%%%%%%%%%%%%%%%%%%%%%%%%%%%%%%%%%%%%%%%%%%%%%%%%%%%%%%%%%%%%%%%%%%%%%%%
