%%%%%%%%%%%%%%%%%%%%%%%%%%%%%%%%%%%%%%%%%%%%%%%%%%%%%%%%%%%%%%%%%%%%%%%%%%%%%%%%%%%%%%%%%%%%%%%%%%%%%
%%%%%%%     %%%     %     %%%   %%%     %%%   %%%%%             %%%%%%% %         %%%   %%%%%   %%%%%
%%%%%%% %%%%%%% %%% %%% %%%%% % %%% %%% %%%%% %%%%% %%% %%%%% %%%%%%%%% % %%%%% %%%%%%% %%%%%%% %%%%%
% %%%   %%%     %   %%% %%%%% % %%% %%%   %%%       %%%   %   %%%       % %%%%%   %%%   %   %%%   %%%
% %%% %%%%% % %%% %%%%% %%%%%%% %%%%%%% %%%%%%%%%%%%%%%%% %%%%%%% %%%%%%% %%%%%%% %%% %%% % %%% % %%%
%   %       % %%%           %%%   %%%       %%%%%%%%%     %%%%%     %     %       %%% %%% % %%% %   %
% % % %%% %%% %%%%% %%%%%%%%%%% %%%%% %%% % %%%%%%%%% %%%%%%%%%%%%% % %%%%% %%%%%%%%% %%% % %%%%%%% %
% %   %%% %%%   %%% %%%         %%%   %%% %     %     %%%     %%%%%   %%%%% %%%%%%%       %         %
% %%%%%%%%%%% %%%%% %%% %%%%% % %%% %%%%%%%%%%% % %%% %%% %%% %%%%% %%%%%%% %%%%%%%%%%%%%%% %%%%% %%%
% %%%%%       %%%%% %%%   %%% % %   % %%%%% %%%     %   % %%%   %%% %%% %%%   %%%%%%%%%%%%%   %%% %%%
%%%%%%%%% % %%%%%%% %%% %%%%% %%% %%% %%%%% %%%%%%%%% %%% %%%%% %%% %%% %%%%% %%%%%%%%%%%%% % %%% %%%
%%%%%     % %%%%%   %   %%%%%     %%% %         %%%   %%%   %%%         %%%%% %%%%% %%%     % % %   %
%%%%% %%%%% %%%%%%% % %%%%%%%%%%%%%%% % %%%%% %%%%% %%%%%%% %%%%%%%%%%%%%%%%% %%%%% %%%%%%% % % %%% %
%         % %%%   % % % %%%                 %   %   %%%%%%%     %   %%%%%         % %%%%%%% % %     %
% %%% %%% %%%%% % %%% % %%%%% %%%%%%%%%%%%%%%%% % %%%%%%%%%%%%% % %%%%%%%%%%% %%% % %%%%%%%%% %%%%%%%
% %%% %%% %%%   % %%%   %%%%% %%%       %       % %%%%%%% %%%   %       %%%%% %%%   %%%%%%%   %%%%%%%
% %%%%%%% %%% %%% %%%%% %%%%% %%% % %%%%% %%%%% % %%%%%%% %%% %%%%%%% %%%%%%% %%%%% %%%%%%% % %%%%%%%
% %%%%%   %   %%%       %       % % %%%%% %%%   % %%%%%     % %       %%%%% %   %%% %%%     % %     %
%%%%%%% %%% %%%%%%%%%%%%%%%%%%% %%% %%%%% %%%%%%% %%%%%%%%% % %%% %%% %%%%% % % %%%%%%% % %%%%% %%% %
%%% %%% %%%       %%%%%%%     %         %   %%%%% %%% %%%%% %   %   %   %   % %   %%%%% % %     %%% %
%%% %%% %%%%%%%%% %%%%%%% %%% %%%%% %%% % %%%%%%% %%% %%%%% %%% %%% %%% %%% % % %%%%%%%%% % %%%%%%% %
%       %     %   %%%     %%%   %   %%% % %%%%%     %         %     %%%   % % % %%%       % %%%%%   %
% %%%%% %%%%% % %%%%%%% %%%%%%% %%%%%%%%% %%%%%%%%% % %%%%%%% %%% %%%%%%% % % %%%%% %%% %%% %%%%% % %
% %%%%%   %   %         %%% %%%   %%% %%%     %%%%% % %   %%%     %%%   % % % %%%     % %   %     % %
% %%%%%%% % %%% %%%%%%%%%%% %%%%% %%% %%%%%%% %%%%% % % %%%%% %%%%%%% %%% % % %%% %%%%% % %%% %%% %%%
%   %%%   % %%% %%%%%       %%%       %%%%%%% %%%       %%%       %%%     % % %   %%%%%   %%% %S% %%%
% %%%%% %%% %%%%%%%%% %%% %%%%% %%%%%%%%%%%%% %%%%% %%% %%%%%%%%%%%%% %%%%% % % %%%%%%%%% %%% % %%%%%
%   %%%     %%%%% %%%   % %%%     %%%%%%%%%%%   %%% %%%   %%%%%%%%%     %   %   %   %%%%%   % %   % %
%%% %%%%%%% %%%%% %%%%% %%%%% %%%%%%%%%%%%%%%%% %%%%%%%%% %%%%%%%%%%%%% % %%% %%% % %%%%%%%%% %%% % %
%%% %%%%% % %%%   %%%%%     % % %%%   %%%%%%%%%   %%%%%%%     %%%%%%% %   %%%     %   %       %     %
%%% %%%%% % %%% %%%%%%%%% % % % %%%%% %%%%%%%%%%% %%%%%%% %%%%%%%%%%% %%% %%%%%%%%% %%% %%%%% % %%%%%
%   %     %     %%%%% %%% %   %   %%%   %%%%%%%%% %%%%%%% %%%%%%%%%%%   %   %%%%% % %   %%%   % %%%%%
% %%% %%% %%%%% %%%%% %%% %%%%% %%%%% % %%%%%%%%% %%%%%%%%%%%%%%%%%%%%% % %%%%%%% % % %%%%%%%%% %%%%%
%   % %%%   %   %%%     %   %%% %%%%% % %%%%%     %%%%%%%%%%% %%%%% %%%   %%%%%     %           % %%%
% % %%%%% %%% %%%%%%% % %%% %%% %%%%%%% %%%%%%% % %%%%%%%%%%% %%%%% %%%%%%%%%%% %%%%%%% %%%%%%%%% %%%
% %   %%%     %%%%%%% % %%%         %%%     %   % %%%%%   %%%       %%%%%%%%%   % %%%%% %%% %%%     %
%%%%% %%% %%%%%%%%%%%%% %%%%%%%%%%% %%% %%% % % %%%%%%% % %%%%% %%%%%%%%%%%%%%% % %%%%%%%%% %%%%%%% %
%%%%% %     %       %%% %%%%%%%     %   %%%   % %%%%%%% %   %%% %%%%% %%%   %%%       %%%     %%%   %
%%%%% % %%% % %%%%% %%% %%%%%%%%% %%%%% %%% %%% %%%%%%% %%%%%%% %%%%% %%% %%%%%%% %%%%%%% %%% %%% % %
%%%%% % %%%   %%%%%   %       %%%   %   %%% %%% %       %%%%%%%       %   %%%%%   %%%%%   %%%     % %
%%%%% %%%%%%%%%%%%% %%% %%%%% %%%%% % %%%%%%%%% %%%%%%% %%%%%%%%%%% % %%% %%%%% %%%%%%%%%%%%% % %%%%%
%       %%%%%       %%%   %%%   % %   %%% %%%   %%%%%%%     %%%     % %     %%% %%%         % % %%%%%
% %%%%% %%%%%%%%%%%%%%% %%%%% % % %%%%%%% %%%%% %%%%%%% %%%%%%% % %%% % %%% %%%%%%%%%%% %%% % %%%%%%%
% %   %    !  %%%%%%%   %%% % %           %%%%%     %%%   %%%%% % %%%   %     %%%   %%%   % % %%% %%%
% %%% %%%%%%% %%%%%%% %%%%% % %%%%% %%%%% %%%%%%%%% %%%%% %%%%% %%%%%%%%%%%%% %%% % %%%%% % % %%% %%%
% %%%   %%% %     %%%     % %     % %%%   %%%       %     %%%     %     %%% % %   %   %%% % %       %
% %%%%% %%% %%% % %%%%%%% % %%%%% %%%%% %%%%%%% %%% %%% % %%%%%%% %%% % %%% % % %%%%% %%% % %%% % %%%
% %%%%% %%% %%% %   %%%%%     %%%     % %%% %%% %%%   % %     %%% %%% % %   % %   %%% %   %     % %%%
% %%%%% %%% %%%%% % %%%%% %%% %%% %%% % %%% %%% %%%%% % %%%%% %%% %%% % %%% % %%% %%% % % %%% %%% %%%
%       %     %%% %       %%% %%% %%% % %%%     %%% % % %     %%% %   %     %     %%% % % %%% %%% %%%
%%%%%%% % % %%%%%%%%%%%%% %%%%%%% %%% %%%%%%% %%%%% % % %%% %%%%% % % %%%%%%% %%%%%%% % %%%%%%%%%%%%%
% %%% % % % %%% %%%%%%%%% %%%%%%% %   %%%%%%% %%%   % %   % %%%   % % %%%%%%% %%%%%   % %%% %%%%%%%%%
% %%% % % %%%%% %%%%%%%%%%%%%%%%%%% %%%%%%%%% %%%%% % %%% % %%% %%% %%%%%%%%%%%%%%% %%% %%% %%%%%%%%%
% %%%   % %%%   %%%%%%% %%%%%%% %%%       %%% %%%%%   %%% %     %   %%%     %%%   % %   %%%     %%%%%
% %%% %%% %%%%% %%%%%%% %%%%%%% %%%%% %%% %%%%%%%%% %%%%% %%%%%%% %%%%% %%% %%% % % % %%%%%%% %%%%%%%
%   % %%%     %   %%%%%       % %%%%% %%% % %%%%%%%   %%%     %   %%%     % %%% % %   %%%     %%%%%%%
% % % %%%%% % % %%%%%%%%%%% % % %%%%% %%% % %%%%%%%%% %%%%%%% % %%%%%%%%% % %%%%% %%% %%%%% %%%%%%%%%
% % %   %   %   %%%%%%%%%   %         %   %     %%% % %%%%%   %   %%%%%   % %%%%% %   % %%%     %%%%%
% % %%% % %%%%% %%%%%%%%% %%%%%%%%%%%%% %%%%%%% %%% % %%%%% %%%%% %%%%%%%%% %%%%% % %%% %%% % % %%%%%
% % %%%   %   %       %%%   %%%%%%%%% %         %%%   %%%   % %%% %   %%%   %%%%%       %%% % % % %%%
% % %%%%%%% % %%% %%%%%%%%% %%%%%%%%% %%%%%%% %%%%%%% %%% %%% %%% % % %%% %%%%%%%%%%%%% %%%%% % % %%%
% %       % % %%% %   % %%%   %%%     %%%%% % %%%%%%%     %%% %%%   %           %%%   %     % %     %
%%%%%%% % % % %%% % % % %%%%% %%%%%%% %%%%% % %%%%%%%%%%% %%% %%% %%%%%%% % %%% %%% % %%%%% % %%% %%%
%%%%%%% %   % %   % %     %   % %%%%%           %%%%%%%%% %%%     %%%%%%% % %%%     %   %%%   %   %%%
%%%%%%%%% %%% % %%% %%%%% % %%% %%%%% %%%%% %%% %%%%%%%%%%%%% %%%%%%%%%%%%% %%%%% %%%%% %%%%%%%%% %%%
%   %%%%%   %   %%% %       %   %     %%%%% %%% %%%%%   %%%%% %             %%%%% %%%%%   %%%%%%%   %
%%% %%%%%%%%% %%%%% %%%%%%%%%%% % %%%%%%%%% %%% %%%%%%% %%%%%%% %%%%% %%%%% %%%%%%%%%%%%%%%%%%%%%%% %
%%%   %%%%%%% %%%%%   %%%%%%%%%   % %%%%%   %%% %   %%%         %     %%%   %%%%%%%%%%%     %%%     %
%%% %%%%%%%%%%%%%%% % %%%%%%%%%%% % %%%%%%%%%%%%% % %%% %%%%% %%% %%%%%%% %%%%%%%%%%%%% %%% %%% %%%%%
%   %%%     %%% %   %   %%%   %%%   %%%         % % %%% % %   %%% %%%%%%% %%%%%%%%%       %     %   %
% %%%%%%% %%%%% % %%% %%%%% % %%%%% %%% %%%%%%% % % %%% % % % %%% %%%%%%%%%%%%%%%%%%% %%%%%%%%%%% %%%
% %%% %%%       %   % %%%%% %   %%% %%%   %%%%%   %       % % %%%       %%%   %%%%%%% % %%%%%%%%%   %
% %%% %%%%% %%% % %%% %%%%% %%% %%%%%%%%% %%%%%%%%%%%%% %%% %%%%% %%%%% %%% % %%%%%%% % %%%%%%%%%%% %
% %%% %%%%%   %   %%%         % %%%     %   %%%   %%%%% %%%   %   %%%%% %%% %   %%%%%     %     %   %
% %%% %%%%% %%%%%%%%%%%%%%% % %%%%% %%% %%% %%% % %%%%%%%%%%% %%%%%%%%%%%%% %%% %%%%%%%%% % %%% % %%%
%       %   %%%%%       %%% %       %%%   %   % %   %%%%%     %   %%% %%%%% %   %%% %%%%%   %%%   %%%
% %%%%% % %%%%%%%%%%% %%%%% %%%%%%% %%%%% %%% % %%% %%%%%%% % % % %%% %%%%% % %%%%% %%%%%%% %%%%%%%%%
% %%%%% % %%%   %%%%% %   %   %%%%% %       %   %%%     %%% % % %     %%%   % %%%   %%%       %%%%% %
%%%%%%% % %%%%% %%%%% % % %%%%%%%%%%% %%%%% %%%%%%% %%%%%%% %%% %%% % %%% % %%%%%%% %%% %%%%%%%%%%% %
%%%%%   %         %%% % %     %   %%% %     %%%     %%%%%   %   %%% %   % %         %%% %   %%%     %
%%%%% %%%%% %%%%% %%% % %%%%% % %%%%% %%% %%%%% %%% %%%%% %%% %%%%%%%%% % %%%%%%% % %%% %%% %%%%%%% %
% %%%       %%%       % %%%%% %       %%% %%%%% %%% %%%       %%% %%%%% %     %%% % %%% %%%     %   %
% %%%%%%% %%%%% %%%%%%% %%%%% %%% %%% %%%%%%%%% %%%%%%% %%%%%%%%% %%%%% % %%%%%%% %%%%% %%% % % % % %
%       % %%%     %%%   %     %   %%%   %%% %%%   %%%     %%%       %%%   %       %%%     % % %   % %
% %%% % %%%%%%%%% %%% %%% %%%%% %%%%% %%%%% %%% %%%%%%%%% %%% %%% %%%%% %%% % %%%%%%%%%%% %%% %%%%%%%
% %%% % %%% %%%%%   % %   %     %%% % %%%       %       %     %%% %%%   %   % %%%%%%%%% % %%% %%%%%%%
% %%% % %%% %%%%%%%%% %%% % % %%%%% % %%% %%%%%%% %%%%% %%%%%%%%%%%%%%%%% %%%%%%%%%%%%% % %%% %%%%%%%
% %%% % %%%         % %%%   % %%%   %   % %%%   %   %   %%%%%%%%%%% %%%%%   %%%%%%%%%%%   %%%   %%%%%
%%%%% % %%% %%% %%% % %%%%% %%%%% % % %%% %%% %%%%% %%% %%%%%%%%%%% %%%%%%% %%%%%%%%%%% %%%%% % %%%%%
%%%   %     %   %%% %   %%% %%%   %   %%% %%%   %   %%% %%%             %%%     %%%%% % %%%   %   %%%
%%%%% %%%%%%% %%%%% %%% %%% %%%%% %%%%%%% %%%%% % %%%%% %%% %%% %%%%%%% %%% %%% %%%%% % %%% % %%% %%%
%%%%%     %%% %%%   %%% %%%   %%% %%%     %%%%% %     %     %%% %   %       %%%   %%% %   % % %%% %%%
%%%%% %%% %%%%%%% %%%%% %%%%%%%%% %%% %%%%%%%%% %%%%% % %%%%%%%%% % %%% %%%%%%%%%%%%% %%% % %%%%%%%%%
%%%   %%% %%%%%         %%%%%%%     % %%%%%     %   % % %%%     % % %%% %         %     %   %%% %%%%%
%%% %%%%% %%%%%%% %%% %%%%%%%%%%%%%%% %%%%% %%% % %%% %%%%% %%% % % %%%%% %%%%% % % %%% %%% %%% %%%%%
%   %%%       %%% %%% %     %%%%%%%     %%% %     %%% %%%%% % %   %   %%% % %%% %   % %   %     %%% %
% %%%%%%% %%% %%%%%%%%% %%% %%%%%%% %%% %%% % %%% %%% %%%%% % %%% %%% %%% % %%% %%%%% %%% %%%%% %%% %
% %%% %%% %   %%%%%%%%% %   %       %%%     % %%% %%%     %   %%% %%%       %%% %%%   %   %%%%% %   %
% %%% %%% % %%%%%%%%%%% % %%% %%%%%%%%%%%%%%% %%%%%%% %%% %%% %%% %%% %%%%% %%% %%% % % %%%%%%% % % %
%     %%% %             %     %%%%%%%%%         %%%%%   %     %%% %%% %%%%% %%%     % %           % %
%%%%%%%%%%%%%%%%%%%%%%%%%%%%%%%%%%%%%%%%%%%%%%%%%%%%%%%%%%%%%%%%%%%%%%%%%%%%%%%%%%%%%%%%%%%%%%%%%%%%%
