%%%%%%%%%%%%%%%%%%%%%%%%%%%%%%%%%%%%%%%%%%%%%%%%%%%%%%%%%%%%%%%%%%%%%%%%%%%%%%%%%%%%%%%%%%%%%%%%%%%%%
% %%% %%%%%%%%%   %%%%%     %       %%%   %%% %%%     %           %%%%%   %%% %%%           %%%%%   %
% %%% %%%%%%%%% % %%%%% %%% % %%% % %%%%% %%% %%% %%% % %%%%%%%%% %%%%% %%%%% %%% %%%%%%%%% %%%%% % %
%         %     %   %   % %   %%% %   %%%   %     %%% % %   %%%     %%%     % %%%   % %%%       % % %
%%%%% %%% % %%% %%% % %%% %%%%%%% % %%%%% %%% %%% %%% % % %%%%% %%%%%%%%% % % %%%%% % %%% %%%%% %%% %
%%%%%   %   %%% %%% %     %%%%%   % %%%       %%%   % %   %%%%%           % %           % % %%% %%% %
%%%%% %%% %%%%% %%%%%%%%% %%%%%%% %%%%% %%%%% %%%%% %%% %%%%%%%%%%% %%% %%% %%%%%%%%%%%%% % %%% %%% %
%%%   %%% %%%     %%%%%     %%%%% %%%   %%%%%     %     %%% %%% %%% %   %%%   %   %   %%% % %%% %%% %
%%%%% %%%%%%%%% % %%%%% %%% %%%%% %%% %%%%%%%%% %%% %%%%%%% %%% %%%%% %%%%%%% % % % % %%% % %%% %%% %
%%%%% % %%%%%%% %   %   %%% % %%%     %%%   %%% %%%     %%%       %%% %%%     % %   %     %     %   %
%%%%% % %%%%%%%%%%% % %%%%% % %%%%% %%%%%%% %%% %%%%%%% %%% %%%%%%%%% %%%%%%% % %%%%%%% %%%%% %%% % %
% %%%   %%%%%       %   %%%     %%% %%%%%%%   % %%%%%       %%%       % %%%%% % %%%     %%%%% %   % %
% %%%%% %%%%% %%% %%%%% %%%%% %%%%%%%%%%%%% %%% %%%%% %%%%% %%% %%%%%%% %%%%% % %%%%%%% %%%%% % %%% %
%   %%% %%%   %%% %%% % %%%%% %%%%%%%%%%%%%     %%%   %%%%% %%% %%%%%     %%%   % %%%%% %%%%%   %%% %
%%% %%% %%% % %%%%%%% % %%%%%%%%%%%%%%%%%%%%%%%%%%%%%%%%%%%%%%% %%%%% %%% %%%%% % %%%%%%%%%%% %%%%% %
%%%       % % %%%%%     %   %%%   %%%%%%%%%%%%%%%%%%%%%%%%%%%   %       %   %         %%%   % %%%   %
%%% %%%%%%% %%%%%%%%% %%%%% %%%%% %%%%%%%%%%%%%%%%%%%%%%%%%%% %%% %%%%%%%%% % %%% %%%%%%%%% % %%%%% %
% % %%% %%%       %%% %%%     %%%   %%%%%%%%%%%%%%%%%%%%%%%   %%% %%%%%%%%%   %%% %%%%% %%% % % %%% %
% % %%% %%% %%%%% %%% %%% %%% %%%%% %%%%%%%%%%%%%%%%%%%%%%%%% %%%%%%%%%%%%%%%%%%%%%%%%% %%% % % %%%%%
%       %%%   %%%   %     %%% %   %   %%%%%%%%%%%%%%%%%%%%%%%   %%%%%     %%%%%%%%%%%%% %     %!%%%%%
% %%%%% %%%%% %%% %%%%% %%%%% % % % % %%%%%%%%%%%%%%%%%%%%%%% %%%%%%% %%% %%%%%%%%%%%%% % %%%%% %%%%%
% %%%%% % %%% %%% %     %%%%%   %   % %%%%%%%%%%%%%%%%%%%%%%%           % %       %%%   %         %%%
% %%%%% % %%%%%%% % %%% %%%%%%%%%%% %%%%%%%%%%%%%%%%%%%%%%%%% %%%%%%%%% % %%%%% %%%%%%% %%%%%%% %%%%%
% %%%%%   %%%%% %   %%% %%%%%%%%%   %%%%%%%%%%%%% %%%%%%%%%   %   %%%   % %     %%%%%%% %%%%%%% %%%%%
%%%%%%%%% %%%%% %%%%%%%%%%%%%%%%%%%%%%%%%%%%%%%%% %%%%%%%%% %%% %%%%%%%%% % %%% %%%%%%% %%%%%%% %%%%%
%%%     %   %%% %%%%% %%% %%% %%%%%%% %%%   %%%   %%%     % %       %%%%% % %%% %   %%%             %
%%% % % %%% %%% %%%%% %%% %%% %%%%%%% %%%%% %%% %%%%% %%%%% % %%% %%%%%%% % %%%%% % %%% %%%%%%% %%%%%
%%% % % %%% %%%       %%%     %%% %%% %%%%% %         %%%%% % %%% %%%     %   %   %     %%%%%%% %%%%%
%%%%% %%%%% %%%%% %%% %%% % %%%%% %%% %%%%% % %%%%%%% %%%%% %%%%% %%%%%%% %%% % %%%%%%%%%%%%%%% %%%%%
%%%%% %   % %%%%% %   %%% % %%%       %%%%%     %%%%%   %%% %%%     %%%%% %%%   %%%       %   %   % %
%%%%% % % % %%%%% % % %%% %%%%% %%% %%%%%%%%%%% %%%%% %%%%% %%%%% %%%%%%% %%% %%%%% %%%%% %%% %%% % %
%%%%%   % % %     % %     %%%%%   % %%%%% %%%   %%%%%   %%% %     %%%%%   %   %%%   %     %%%       %
%%%%% %%% % %%%%%%% %%% %%%%%%%%% %%%%%%% %%% %%%%%%% % %%% % %%%%%%%%% %%% %%%%%%% %%% %%%%%%%%%%% %
%     %   % %%%     %%% %%%   %%% %%%         %%%%%   %       %%%     % %%% %%%S    %%%   %   %%%%% %
%%%%% % %%% %%% %%% %%%%%%% %%%%% %%%%%%%%% %%%%%%% %%%%%%%%%%%%% %%% % %%% %%%%%%%%%%%%% % % %%%%%%%
%   % % %%% %   %%% % %%%   %     %%%%%%%%% %%%       %%%%%%%%%   %     %         %%%     % % % %%%%%
% % %%% %%% % %%%%% % %%% %%% %%% %%%%%%%%% %%% %%%%%%%%%%%%%%% % %%%%% %%%%%%%%% %%%%%%% % % % %%%%%
% %       % %   %%%   %%%     %%%         % %%%   % %%%%%   %   %   %%% %%% %%% % %%%%%%%   %       %
% % %%% %%% %%% %%% %%%%% %%%%%%% %%%%% % % %%%%% % %%%%% %%% %%%%% %%%%%%% %%% % %%%%%%%%%%%%%%%%% %
% % %%% %%% %%% %   %%%   %%%%%   %%%%% % % %%%       %%%   %   %%% %%%%%         %%%   %%% %%%%%%% %
% %%%%%%%%% %%% %%%%%%% %%%%%%%%%%%%%%%%% % %%% %%%%% %%%%% % %%%%% %%%%% %%%%%%% %%%%% %%% %%%%%%% %
% %%% %%%%%     %%%%%   %%%%%       % %%%   %%% % %%% %%%%%   %       %%% %   %%%   %%%           % %
% %%% %%%%%%%%% %%%%%%%%%%%%% %%%%% % %%% %%%%% % %%%%%%%%%%%%% % %%%%%%% % %%%%%%%%%%%%% %%%%% %%% %
%           %%% % %%%%%%%     %%%   %     %%%%%   %%%%%%%%%%%%% % %%%%%     %%%%%%%%%%%%% %%%%%     %
%%% %%%%%%% %%% % %%%%%%%%%%% %%% %%%%%%%%%%%%% %%%%%%%%%%%%%%% %%%%%%% %%%%%%%%%%%%%%%%%%%%%%% %%% %
%%%   % %%% %%%   %     %%%%% %%% %%%%%%%%%%%%% %%% %%%%%%%%%%%   %%%%% %%%%%%%%%%%%%%%%%%%%% % %%% %
%%%%% % %%% %%%%% %%% % %%%%% %%% %%%%%%%%%%%%% %%% %%%%%%%%%%%%% %%%%% %%%%%%%%%%%%%%%%%%%%% % %%%%%
%       %   %%%   %%% % %     %   %   %   %%% %     %%%%%%%%%%%%% %%%       %%%%%%%%%%%%% %     % %%%
% %%%%% % %%%%% %%%%% % % %%% %%% % % % % %%% % %%%%%%%%%%%%%%%%% %%% %%%%% %%%%%%%%%%%%% % %%% % %%%
% %%%   % %   %       % %   % %%%   %   %   %   %%%   %%%%%%%%%     % %%%   %%%%%%%%%%%     %%%   %%%
% %%% %%% % % %%%%%%% %%% % % %%%%% %%%%%%% %%%%%%% % %%%%%%%%%%%%% %%%%%%% %%%%%%%%%%% %%%%%%%%%%%%%
% %%% %%%   %         %%% % %   %%% %%%%%%%         %   %%%%% %%%%%     %%%   %%% %%%%% %%%   %%%%%%%
%%%%%%%%%%% %%%%%%%%%%%%%%% %%%%%%%%%%%%%%%%%%%%%%%%%%% %%%%% %%%%% %%% %%%%% %%% %%%%% %%% % %%%%%%%
%%%%%%% %%% %%%%% %%%   %%% %%%%%%%%%     %%%   %%%     %   %       %     %%%       % %     %     %%%
%%%%%%% %%% %%%%% %%%%% %%% %%%%%%%%%%% %%%%% % %%% %%%%% % % %%%%%%% %%%%%%% %%%%% % %%%%%%% %%%%%%%
% %%%   %%%   %%% %%%     %             %%%   % %   %%%%% % % %%%   %     %%% %%%%%     %%%   %%%%% %
% %%% % %%%%% %%% %%% %%% %%%%%%% %%%%%%%%%%% %%% %%%%%%% %%% %%% % %%%%% %%%%%%%%%%% %%%%% %%%%%%% %
%     %   %%% %   %%% %%%   %%%%%   %%%%% %%%     %           %   %     %   %%%   %   %%%%% %%%%%%% %
%%% %%%%%%%%% % %%%%% %%%%% %%%%%%% %%%%% %%% %%%%% %%% %%% %%% %%%%% % %%% %%%%% % %%%%%%% %%%%%%% %
%%%     %%%     %%%     %%% %%%     % %%% %%%   %   %%% %%% %%%   %%% % %%% %%%%%   %%%       %%%   %
%%% %%% %%% %%%%%%% % %%%%%%%%% %%%%% %%% %%%%% %%%%%%%%%%% %%%%%%%%% % %%% %%%%% %%%%% %%%%%%%%% %%%
%%% %%% %     %%%%% % %%%%%%%   %%%%%         %   %%% %%%             % %   %%%%% %%%       %%%     %
%%% %%% % %%% %%%%%%% %%%%%%% % %%%%% %%% %%%%%%% %%% %%%%%%% %%% %%%%%%% %%%%%%%%%%% %%%%%%%%%%%%% %
%%% %%% % %%%   % %%%   %%%   % %%%   %   %%%%% % %%% %%%%%%% %%% %%%%%%%     %       % %%%%% %%%   %
%%% %%% % %%%%% % %%% %%%%% %%%%%%% %%% % %%%%% % %%% %%%%%%%%%%%%%%%%%%%%% %%% %%%%%%% %%%%% %%% % %
%     %     %%%       %%%   % %%%%% %   % %%%         %%%   %%% %%% %%% %%%   %     %%%           % %
%%%%% %%%%%%%%%%%%% %%%%% %%% %%%%%%% %%% %%% %%%%%%% %%% %%%%% %%% %%% %%%%% %%% %%%%%%%%%%% %%%%% %
%%%   % %%%%% %%%   %%%     %         %%%   %   %%%   %%%               %%%     % %%%%%%%%%%%   %%% %
%%%%% % %%%%% %%%%%%%%% %%% %%%%%%% % %%%%%%% %%%%%%% %%%%%%%%% % %%%%% %%% %%%%% %%%%%%%%%%%%% %%%%%
% %%%     %     %%%%%     % %%%     % %       %%%%%%% %%%       % %%%       %%%%%       %         %%%
% %%% %%% % % %%%%%%%%% %%% %%% % %%%%% %%%%%%%%%%%%% %%% %%%%%%% %%%%%%%%%%%%%%%%%%%%% %%% % % %%%%%
% %%% %%% % % %%%   %%% %   %   % %%%%%     %%% %%%%%     %%%   %   %%%%%%%%%   %%%%%%% %%% % % %%%%%
% %%%%%%% %%% %%%%% %%%%% %%% %%%%%%%%%%%%% %%% %%%%%%%%%%%%%%% % %%%%%%%%%%%%% %%%%%%% %%% % % %%%%%
% %%%%%%%   %   %%% %%%%% %%%               %%%     %%%%%%%%%%% % %%%%%%%             %   % % %   %%%
% %%%%%%%%% % % %%% %%%%% %%%%% %%% %%%%%%% %%% %%% %%%%%%%%%%% % %%%%%%% %%%%% %%%%%%%%% %%% %%%%%%%
%       %   % %       %%%   %%% %%%     %%% %%% %       % %     %   %%%   %%%   %%%%%%% %     %%%%% %
% %%% %%% %%%%%%% % %%%%% %%%%% %%%%% %%%%% %%% % %%%%% % % %%% %%% %%% % %%%%% %%%%%%% %%% %%%%%%% %
% %%%             % %%%     %     %%% %%%%% %%% % %%%     % % % %%% %   % %%%%% %%% %     % %%%%%%% %
% %%%%%%%%%%%%%%% %%%%% %%% %%%%% %%%%%%%%%%%%%%% %%%%%%%%% % % %%% % %%%%%%%%% %%% % % %%% %%%%%%% %
% %%%%%%% %%%     %%%   %%% %%%   %%%%%%%%%%% %%%   %%%   %   % %     %%%%% %   %%%   %     % %%%   %
%%%%%%%%% %%% %%%%%%%%%%%%% %%% %%%%%%%%%%%%% %%% % %%% % %%% % % %%%%%%%%% % %%%%%%% %%%%%%% %%%%% %
%%% %%%     %   %%% %%%     %%%   %%%%%%%%%%%     %     %   % %   %%%%%%%     %%%%%%%     %%%       %
%%% %%%%% % %%% %%% %%% %%%%%%% %%%%%%%%%%%%% %%%%%%%%% %%% % %%%%%%%%%%% %%%%%%%%%%% %%%%%%% %%% %%%
%     %%% % %%%   % %%% %%%     %%%%%%%%%%%   %%% %%%%%   %         % %%% %%%%% %%%   %%%%% %   %   %
% % %%%%% %%%%%%% % %%% %%%%% %%%%%%%%%%%%%%% %%% %%%%%%% %%%%%%%%% % %%%%%%%%% %%% %%%%%%% % %%%%% %
% % %%%   %%%%%%% %   %   %%% % %%%%%%%%%%%%%       %%%   %%%%%%%       %%% %         %%% %   %   % %
% %%%%%%% %%%%%%% % %%% %%%%% % %%%%%%%%%%%%%%%%%%% %%% %%%%%%%%% %%%%%%%%% % %%% %%% %%% % %%% % % %
%     %%%   %%%%%   %%%   % % %   %%%%%%%%%%%%%%%   %%% %     %   %           %%% %%% %%%   %   %   %
% % % %%% %%%%%%% %%%%%%% % % % %%%%%%%%%%%%%%%%% %%%%% % %%% %%% % %%% %%%%% %%%%%%%%%%%%%%% %%%%% %
% % % %%% %%%     %%%     % %   %%%%%%%%%%%%%%% %   %%% % %%%   % % %%% %%%%% %%%%% %%%%%   %   %%% %
%%% %%%%% %%% %%%%%%% %%%%% % %%%%%%%%%%%%%%%%% % %%%%%%% %%%%% %%% %%%%%%%%% %%%%% %%%%% % %%% %%%%%
%%% %%%   %%%       % %%%%%   %%%%% %%%%%%%%%     %%%%%%% % %%% %     %%%   % %   %       %   %     %
%%% %%% %%%%% %%%%%%% %%%%% %%%%%%% %%%%%%%%% %%% %%%%%%% % %%% % %%% %%%%% % % % %%% %%%%%%% %%%%% %
%%% %%%   %%% %%%%%%%   %   %%%             % %%%   %%% %   % %   %%% %%%%% %   %     % %%%%% %     %
%%% %%%%% %%% %%%%%%%%% %%%%%%%%%%% %%%%%%% %%%%%%%%%%% %%% % %%% %%%%%%%%% %%% %%%%%%% %%%%% % %%% %
%     %%%   %     %%%%% %%%%%%%%%%% %%%%% %     %%%%%         %%%   %%% %%%     %%%%%   %%%%% % %%% %
%%% %%%%% % %%%%% %%%%% %%%%%%%%%%% %%%%% %%%%% %%%%%%%%%%% %%%%%%% %%% %%% %%%%%%%%%%% %%%%% % %%% %
%%%   %   % %%%%%   %   %%% %%%       %%%     %   %%%%%%%%% %%% %%%   % %%%   %%%       %%% % % %%% %
%%%%% % %%% %%%%% %%% %%%%% %%% %%%%% %%%%%%% % %%%%%%%%%%% %%% %%%%% % %%%%% %%%%%%% %%%%% % % %%% %
%%%%%   %%%       %%%             %%%         %                 %%%       %%%   %%%%%           %   %
%%%%%%%%%%%%%%%%%%%%%%%%%%%%%%%%%%%%%%%%%%%%%%%%%%%%%%%%%%%%%%%%%%%%%%%%%%%%%%%%%%%%%%%%%%%%%%%%%%%%%
