%%%%%%%%%%%%%%%%%%%%%%%%%%%%%%%%%%%%%%%%%%%%%%%%%%%%%%%%%%%%%%%%%%%%%%%%%%%%%%%%%%%%%%%%%%%%%%%%%%%%%
%%% %%% %%%%%%% %         %%%%%%%%%   %%%%%%% %%%%%%%     %%%%%%%%%%%   %%%%%%%%%%%%%%%%%%%%%%%%%%%%%
%%% %%% %%%%%%% % %%%%%%% %%%%%%%%% % %%%%%%% %%%%%%%%% %%%%%%%%%%%%%%% %%%%%%%%%%%%%%%%%%%%%%%%%%%%%
%%%       %%%       %%%%%           % %%%%%       %%%%%   %%%%%%%%%%%%% %%%%%%% %%%%%%%%%%%%%%%%%%%%%
%%%%% %%%%%%% %%%%%%%%%%% % %%%%%%%%% %%%%%%% %%% %%%%%%% %%%%%%%%%%%%% %%%%%%% %%%%%%%%%%%%%%%%%%%%%
%%%%%   %%%     %%%%%     % %%%%%%%         % %%%         %%% %%%%%       %       %%%%%%%%%%%%%%%%%%%
%%%%%%% %%%%%%%%%%%%% %%% % %%%%%%%%%%%%%%% %%%%%%%%% % %%%%% %%%%%%% %%% % %%% % %%%%%%%%%%%%%%%%%%%
%%%%%%% %%%%%%%%% %   %%% %   %%% %%%%%%%     %       % %%%%% %%% %%% %   %   % %     %%% %%%   %%%%%
%%%%%%% %%%%%%%%% % %%%%% % %%%%% %%%%%%% %%% % %%%%%%%%%%%%% %%% %%%%% %%%%% % %%% %%%%% %%% %%%%%%%
%%%%%%%     %     % %   % % %%%   %%%%%%% %%%   %%%%%%%%%%%%%       %%%       % %%% %%%       %%% %%%
%%%%%%%%% % % % %%% % %%% %%%%% %%%%%%%%%%%%%%% %%%%%%%%%%%%%%% %%% %%%%%%% %%% %%% %%%%% %%%%%%% %%%
%%%%%%%%% % % %       %%% %%%%%   %%%%%%%%% %%%         %%% %%% %%%       % %%% %%%   %%% %%%%%     %
%%%%%%%%% % % %%%%%%% %%% %%%%%%% %%%%%%%%% %%%%% %%%%%%%%% %%% %%%%%%%%% %%%%% %%%%% %%% %%%%%%% %%%
%%%%%%%   %       %%% %%% %   %%%   %%%       %%% %%%%%%%%% %%% %%%   %%%       %%%   %%%         %%%
%%%%%%% %%%%%%%%%%%%%%%%% %%% %%% %%%%% %%%%% %%% %%%%%%%%% %%% %%% % %%%%%%%%% %%%%% %%%%%%% % %%%%%
%%%%%   %%%%%%%           %   %%% %%%   %%%     %   %  !  % %%%   % %   %%%   %   %%%         % %%%%%
%%%%% %%%%%%%%% %%%%%%%%%%% %%%%% %%% %%%%%%% %%%%% %%% % % %%%%% % %%% %%% % %%%%%%%%% %%% %%%%%%%%%
%%%%%       %   %           %%%%% %     %%%%% %%%       %     %%% % % %     %     %%%%% %%% %%%     %
%%%%%%% %%%%% %%%%% %%%%%%%%%%%%% % %%% %%%%% %%%%%%% %%%%% %%%%% % % %%%%%%%%%%% %%%%%%%%%%%%% % % %
% %%% % %%%%%     %               % %   %%%   %%%%%%% %%%%% %%%   %       %%%   %         %%%%% % % %
% %%% % %%%%%%%%% % %%%%%%%%% % %%% % %%%%% %%%%%%%%%%%%%%% %%% % % %%%%% %%%%% %%% %%%%% %%%%% % % %
%       %%%       % %%%%%%%   % %   % %%%   %%%   % %%%     %%% %   %%%   %     %%%   %%%       % % %
% %%% %%%%% %%%%% %%%%%%%%% %%%%% %%% %%%%% %%% % % %%% %%% %%%%%%%%%%% %%%%% %%%%%%%%%%% %%%%%%% % %
% %%%     %   %   %%%%%%%   %%%     %   %%% %%% %   %%% %%% %     %%% %       %%% %%%%%   %%%%%   % %
% %%%%%%% %%% %%%%%%%%%%% %%%%% %%% % %%%%%%%%% %%%%%%%%%%% % %%% %%% %%% %%%%%%% %%%%% %%%%%%% %%% %
%   %%%%% %   %     %   %       %%% % %%%%%%%%%     %%%%%%%   %   %%%     %%%%%       % %%%     %%% %
%%% %%%%%%% %%% % %%% % %%%%% %%%%%%% %%%%%%%%%%%%% %%%%%%%%%%% %%%%% %%%%%%%%% % %%% %%%%% %%% %%%%%
%       %%% %   %     %     % %%%     %%% %%% %%%         %%%%% %%%       %%%   % %%%   %     %   %%%
%%%%%%%%%%% % %%%%% %%%%%%% %%%%% %%%%%%% %%% %%% %%% %%% %%%%% %%% %%%%%%%%% %%%%%%%%% %%%%%%%%% %%%
%%%%%%%     % %%%%%     %%%   %%% %%%%%%% %%%     %%% %%%     % %   %%%%%%%%%     %     %%%%%%%     %
%%%%%%% % %%% %%%%%%% %%%%%%% %%% %%%%%%% %%% %%%%%%% %%%%%%%%% %%% %%%%%%%%%%%%% %%% %%%%%%%%% %%%%%
%       % %%%   %   % %%% %%% %     %         %%%%%   %%%       %%%   %%%   %     %%% %%%   %%%     %
%%% %%% %%%%% %%% % % %%% %%% % % % %%%%%%% %%%%%%% %%%%% %%%%%%%%% %%%%% % % %%%%%%% %%% %%%%%%% % %
%%%   %       %   % % %   %%% % % %     %%% %%%%%%% %     %%%%%%%   %%%   %   % %%% %     %%%%%%% % %
%%%%% %%%%%%%%% %%% %%% % %%% % % %%%%% %%% %%%%%%%%% %%%%%%%%%%% %%%%% %%%%%%% %%% %%%%% %%%%%%% % %
%   %     %     % %     %     % %   %         %%%%%%% %%%     %%% %%%     %%%%%       %%%     %%% % %
%%% %%%%% % %%%%% %%% %%% %%%%% %%% %%%%%%% %%%%%%%%% %%% %%%%%%%%%%%%%%% %%%%% %%% %%%%%%% %%%%%%% %
%%% %%%   % %%%%%     %%% %%%%% %   %%% %%% %%%%%%%%%   % %%%%%%%%%%%%%%%     % %%%   %%%   %%%%%%% %
%%% %%% %%% %%%%%%% %%%%%%%%%%% % %%%%% %%% %%%%%%%%%%% % %%%%%%%%%%%%%%%%% % % %%%%% %%% %%%%%%%%% %
%     % %%%     %%% %%% %%%%%   %   %%%         %%%%% %   %%%%%%%%%   %%%%% % %     % %%%           %
%%% %%% %%% % %%%%%%%%% %%%%%%%%% % %%% %%%%%%% %%%%% %%% %%%%%%%%% %%%%%%% % %%%%% % %%% %%%%%%%%% %
%%%     %%% %     %%%   %%%%%%%%% %   % %%%%%%%   %%% %   %           %%%   %   %%% %   % %%%%%     %
%%%%% %%%%%%% % %%%%% %%%%%%%%%%% %%% %%%%%%%%%%% %%% % %%%%% %%% %%% %%%%% %%% %%%%%%% % %%%%%%% %%%
% %%%   %%%%% %   %%% %%% %%%     %%%       %%%   %%%   %%%%% %%% %%%   %%% %%% %%%%%%%     %%%%%   %
% %%%%% %%%%%%%%% %%% %%% %%% %%%%%%%%% % %%%%%%%%%%%%% %%%%%%%%%%%%%%% %%% %%% %%%%%%% %%%%%%%%%%% %
%     % %   %%%%% %%%   %       %%%%%%% % %%%%%%%   %%% % %%%%% %%%     %   %   %%% %%% %%%%%%%   % %
%%% %%% % %%%%%%% %%% % %%%%%%% %%%%%%% %%%%%%%%% % %%% % %%%%% %%% % %%% %%% %%%%% %%%%%%%%%%% %%% %
%%%   %   %%%%% %     %     %%% % %%%       %%%   %   %         %   % %%% %%% %%% %   %%%   %%%     %
%%% % % %%%%%%% % %%% %%%%% %%% % %%%%% %%% %%% %%%%% %%%%%%%%% %%% % %%% %%% %%% % % %%%%% %%% %%% %
%   %   %%%%%     %%% %%% % %     %%%%% %%%     %   %     %%%   %%% %     %%%       %   %%%   % %%% %
%%% %%%%%%%%%%% %%%%%%%%% % %%%%% %%%%% %%%%%%% % % % %%%%%%% %%%%%%% %%%%%%% %%%%% % %%%%% % %%%%%%%
%%%   %%%%%%%%% %%%%%%%%% % %%%%% %%%%%   %%%%%   % %         %%%%%%%   %%%%% %%%%% % %     %       %
%%%%% %%%%%%%%% %%%%%%%%% % %%%%%%%%%%%%% %%%%%%% %%% %%%%%%%%%%%%%%%%%%%%%%% %%%%%%% % %%% %%%%%%% %
%   % % %%% %   %%%       %       %%%   %   %%%   %%%   %%%   %%%%% %%%%%%%     % %%%   %%% %%%%%   %
%%% % % %%% % %%%%%%% %%% %%% %%% %%%%% %%% %%% %%%%% %%%%% %%%%%%% %%%%%%%%%%% % %%%%%%%%%%%%%%% %%%
%%%     %%%     %%%   %%% %%%   %   %%% %%% %%% %%%%% %%%   %       %     %%%%%       %   %%%     %%%
%%% %%%%%%%%%%% %%% %%%%%%%%%%%%% %%%%% %%% %%% %%%%% %%%%% % %%% % % % %%%%%%%%% %%% % % %%%%% % %%%
%%%   %%%%%%%       %%%%%%%       %%%   %%% %%% %%% % %%%%%   %%% %   % %%%   %%% %%%   %   %%% % %%%
%%% %%%%%%%%%%% %%% %%%%%%% %%%%%%%%% %%%%% %%% %%% % %%%%%%%%%%% %%%%% %%% % %%%%%%%%%%% %%%%% %%%%%
%%% %%%%%%%%%%% %%% %%%     %   %%% %   %%% %%% %%%       %%%%%%% %%%       %   %%% %%%   %%%   %%% %
%%% %%%%%%%%%%%%%%%%%%%%% %%% %%%%% % % %%% %%%%%%%%%%%%% %%%%%%%%%%% %%% %%% %%%%% %%% %%%%% %%%%% %
%     %%%%%%%             %%%       % %       %%%%%%%%%%%   %%% %%%   %%% %%% %%%       %   %       %
% %%%%%%%%%%%%% %%%%%%% %%%%% %%% %%% %%%%%%%%%%%%%%%%%%%%% %%% %%% % %%%%%%%%%%%%% %%%%% % %%% %%% %
% %%%%%%%%%%%%%     %%% %%%   %%%     %%%   %%%     %%%   %     %   %   %%%%%%% %%%   %%% %   %   % %
% %%%%%%%%%%%%%%% % %%%%%%% %%%%% %%%%%%% % %%% %%% %%%%% % %%% %%%%% % %%%%%%% %%%%% %%% %%% %%% %%%
% %%% %%% %%% %%% % %%%%%   %%%%% % %%% % % %%%   %   %%%   %%%   %%% % %%%%%%% %%%     % %%% %%%   %
%%%%% %%% %%% %%%%% %%%%%%% %%%%% % %%% % % %%% %%%%% %%%%%%%%%%% %%% % %%%%%%% %%%%%%% %%%%% %%%%% %
%%%%% %%%       %%%   %%%%% %%%     %%%   % %%% %%%%%   %%%%% %%%     %     %%%     %       % %%%%% %
%%%%% %%%%%%% % %%%%% %%%%% %%%%%%%%%%% %%% %%%%%%%%% % %%%%% %%%%%%%%% %%% %%% %%% %%%%%%% % %%%%% %
%%%%% %%%%%%% %   %%%   %%%   %%%%%%%%% %%%   %%%     %       %   %%%%% %%%     %%%   %%%   %     % %
%%%%% %%%%%%% %%% %%% %%%%%%% %%%%%%%%% %%% %%%%% %%%%%%%%%%% % %%%%%%% %%%%%%%%%%%%% %%% %%% % %%% %
% %           %%%     %%% %%%     %%%   % %   %%% %%%%%     % %           %%% %%%%%%%   % %%% % %   %
% % %%%%% %%%%%%% %%%%%%% %%%%% %%%%%%% % %%% %%% %%%%% % %%% %%% %%%%% %%%%% %%%%%%%%% % %%% %%% % %
% % %%%%% %%%%%%% %%%%%     %%% %%%%%%%   %%% %%% %%%   % %%% %%% %%%%% %%%     %%% %   %     %   % %
% % %%%%% %%%%%%% %%%%% %%%%%%% %%%%%%% %%%%% %%% %%%%% % %%% %%%%%%%%%%%%% %%% %%% % %%% %%%%% %%% %
%   %%%       %%% %%%         % %%%%%   %%%       %     %   %   %%%%%%%%%%%   %       %%% %   % %%% %
% %%%%% %%%%% %%% %%%%% %%% %%% %%%%% %%%%%%%%% %%%%% %%%%% %%% %%%%%%%%%%% %%%%% %%% %%%%% % % %%% %
% %%%   %%%     % %   % %%%   %   %%%   % %%%%% % %%% %%%%% %%%   %%% %%%%% %%%%% %%% % %%% %   %%% %
% %%%%% %%%%%%%%% % % %%%%%%% % %%%%%%% % %%%%% % %%% %%%%%%%%%%% %%% %%%%% %%%%%%%%% % %%% %%%%%%% %
%   %%%   %%%%%%%   %       %   %%%%%%% % %%%%%         %  S% %%%     %%%%%     %%% %   %   %%%%%%% %
%%%%%%%%% %%%%%%%%%%%%%%%%% %%% %%%%%%% % %%%%%%%%% %%%%% %%% %%%%%%% %%%%% %%%%%%% %%% % %%%%%%%%% %
%%%%%%%%% %%%     %%% %%%%% %%% %%%%%%%   %   %%%%% %%%%% %     %%%%%   %%% %%%%%   %%%   %%% %%%   %
%%%%%%%%% %%%%%%% %%% %%%%% %%%%%%%%%%%%% % %%%%%%%%%%%%% %%%%% %%%%%%% %%%%%%%%%%% %%%%% %%% %%%%% %
%%%%%%% %   %%%   %     %     %%%     %%%   %%%%%%%%%%%   %%%%%       %     %   %%%   %%%     %%%%% %
%%%%%%% %%% %%% % % % %%% %%%%%%% %%%%%%%%% %%%%%%%%%%% %%%%%%%%%%% % % %%% % % %%% % %%%%%%% %%%%%%%
%   %     % %%% %   % %%%         %%%%%     % %%%   %%% %%% %%%%%   % %   % % % %   %     %   %%% %%%
% %%% % % % %%% % %%% %%%%%%% %%% %%%%% %%%%% %%%%% %%% %%% %%%%% %%% %%%%% %%% % % %%% %%% %%%%% %%%
%     % % %   % % %%%   %%%%% %%%     % %   % %%%%%   % %       % %     %   %%%   % %   %%% %%%     %
% %%%%% %%%%% % %%%%% %%%%%%%%%%% %%%%% % % % %%%%% % % %%% %%% % %%%%% % %%%%%%%%% %%%%%%% %%%%%%% %
% %%%%%     %   %%%%% %%% %%%%% % %     % %         % %     %%%   %%%   % %%% %%%%% %%%%%           %
% %%%%%%%%% %%%%%%%%% %%% %%%%% % % %%%%% %%%%%%%%%%% %%%%% %%%%%%%%%%% % %%% %%%%% %%%%%%%%% %%% %%%
%         %     %     % %       %   %     %       %   %%%%% %%%%%%%%%%%   %         %%% %%%   %%% %%%
% %%%%%%%%% %%% % %%% % % %%% % %%%%% %%%%% %%% %%% %%%%%%%%%%%%%%%%%%%%%%%%%%% %%% %%% %%% %%%%% %%%
% %%%%%%%%% %%%   %%% %   %   %   %   %%%   %%% %%%   %%% %%%%%   %%%%%   %%%   %%%       % %%%%% % %
% %%%%%%%%%%%%% %%%%% %%%%% %%%%% % % %%%%% %%%%%%%%% %%% %%%%% %%%%%%% % %%% %%%%%%% %%%%% %%%%% % %
% %%%%%%%%%%%%% %%%   %%%   %%%   % % % %%%   %%%         %%%%%   %%%%% %       %     %%%%% %%%   % %
% %%%%%%%%%%%%% %%%%% %%% %%%%% %%%%% % %%% %%%%% %%%%%%% %%%%%%% %%%%% %%%%%%% %%%%% %%%%% %%%%% % %
% %%%%%%%%%%%%% %%%%% %   %%%%% %     %           %%%%%   %%% %%%   %   %   %%% %   %   %     %%%   %
% %%%%%%%%%%%%% %%%%% %%% %%%%% % %%% %%% %%%%%%% %%%%%%%%%%% %%% % % %%%%% %%% % % %%%%% %%%%%%%%% %
%     %%%%%%%%%   %%%       %%%   %   %%%     %%%   %%%%%%%       %         %%%   %         %%%%%%% %
%%%%%%%%%%%%%%%%%%%%%%%%%%%%%%%%%%%%%%%%%%%%%%%%%%%%%%%%%%%%%%%%%%%%%%%%%%%%%%%%%%%%%%%%%%%%%%%%%%%%%
