%%%%%%%%%%%%%%%%%%%%%%%%%%%%%%%%%%%%%%%%%%%%%%%%%%%%%%%%%%%%%%%%%%%%%%%%%%%%%%%%%%%%%%%%%%%%%%%%%%%%%
%%%%%%%%%%%%%%%%%%%%%%%%%%%%%%%%%               %%%%%%%     %%% %%% %%%       %         %%%%%%%%%%%%%
%%%%%%%%%%%%%%%%%%%%%%%%%%%%%%%%%%% %%% %%% %%%%%%%%%%%%% % %%% %%% %%% %%%%% % %%%%%%% %%%%%%%%%%%%%
%%%%%%%%%%%%%%%%%%%%%%%%%%%%%%%%%%% %%% %%%   %%%%%%% %%% %         %%% %     % %%%     %%%%%%%%%%%%%
%%%%%%%%%%%%%%%%%%%%%%%%%%%%%%%%%%% %%%%%%%%% %%%%%%% %%% %%%%%%%%% %%% %%% %%%%%%% %%%%%%%%%%%%%%%%%
%%%%%%%%%%%%%%%%%%%%%%%%%%%%%%%%%%%   %%%       %%%     % %         %%% %%% % %%%   %%%%%%%%%%%%%%%%%
%%%%%%%%%%%%%%%%%%%%%%%%%%%%%%%%%%%%%%%%% % %%% %%% %%% % %%%%% %%%%%%% %%% % %%%%% %%%%%%%%%%%%%%%%%
%%%%%%%%%%%%%%%%%%%%%%%%%%%%%%%%%%%%%%%%% % %%% %   %%% % %   % %%%%%   %       %%%         % %%%   %
%%%%%%%%%%%%%%%%%%%%%%%%%%%%%%%%%%%%%%%%% % %%% % %%%%% % % % %%%%%%% %%%%%%% %%%%% %%%%%%% % %%% % %
%%%%%%%%%%%%%%%%%%%%%%%%%%%%%%%%%%%%%     % %%%   %%%     % %   %     %%%%%   %%%%% %         %%% % %
%%%%%%%%%%%%%%%%%%%%%%%%%%%%%%%%%%%%%%% % %%%%% %%%%%%%%% % %%% % %%% %%%%% %%%%%%% %%% %%%%% %%%%% %
%%%%%%%%%%%%%%%%%%%%%%%%%%%%%%%%%%%%%%% %     % %%%%%%%%% % % %   %%%   %     %%%   %%% %%%%% %     %
%%%%%%%%%%%%%%%%%%%%%%%%%%%%%%%%%%%%%%%%%%%%% %%%%%%%%%%%%% % %%% %%%%% %%%%% %%% %%%%% %%%%% % %%% %
%%%%%%%%%%%%%%%%%%%%%%%%%%%%%%% %%%   %%%%%%% %%%           % %%%   %%%     %     %%%%%   %%% % %   %
%%%%%%%%%%%%%%%%%%%%%%%%%%%%%%% %%% %%%%%%%%% %%% %%%%%%%%%%% %%%%% %%%%%%% %%% %%%%%%%%%%%%% % % %%%
%%%%%%%%%%%%%%%%%%%%%%%%%%%%%%%     %%%       %%%   %%%%%%%%%   %%% % %%%%%   % %%%   %%%%%     %   %
%%%%%%%%%%%%%%%%%%%%%%%%%%%%%%% % %%%%%%% %%%%%%%%% %%%%%%%%%%% %%% % %%%%% % % %%% %%%%%%% %%%%%%% %
%%%%%%%%%%%%%%%%%     %%% %%%   % %%%%%%%       %%% %           %%%   %%%   % %     %%%     %%%%% % %
%%%%%%%%%%%%%%%%%%%%% %%% %%%%%%% %%%%%%% %%% % %%% %%% %%%%% %%%%%%%%%%%%%%% %%%%% %%%%% %%%%%%% % %
%%%%%%%%%%%%%%%%%%%%%       %%%%%   %     %%% % %%%     %%% % %%%%%%%   %%%   %     %%%%% %%% %     %
%%%%%%%%%%%%%%%%%%%%%%%%% % %%%%% %%% %%%%%%%%% %%%%% %%%%% % %%%%%%% % %%% %%%%%%% %%%%%%%%% % %%%%%
%%%%%%%%%%%%%%%%%%%%%%%%% %       %%%       %%%   %%% %%%     %%%%%%% % %     %%%%% %%% %%%     %%%%%
%%%%%%%%%%%%%%%%%%%%%%%%%%% %%% %%%%%%% %%% %%%%% %%%%%%%%% %%%%%%%%% % %%% % %%%%%%%%% %%%%%%%%%%%%%
%%%%%%%%%%%%%%%%% %%%   %%% %%% %       %%%   %%%   %%%%%%%     %%%   % %%% %   %       %         %%%
%%%%%%%%%%%%%%%%% %%% %%%%%%%%% % %%%%% %%%%%%%%%%% %%%%%%%%% %%%%% %%% %%% % %%% % %%%%% %%%%%%% %%%
%%%%%%%%%%%%%         %%% %%%%% % %%%%% %%%%%%% %     %%% %   %%%%% %   %   % %   %     % %%%   % %%%
%%%%%%%%%%%%%%% %%%%% %%% %%%%% % %%%%%%%%%%%%% % %%% %%% % %%%%%%% % %%%%%%% % %%% %%% % %%% % % %%%
%%%%%           %%%%% %%%   %%% %     %%%       %   % %%% % % %%%%% % %%%%%%%  !%%% % %   % % %     %
%%%%%%%%%%% % %%%%%%%%%%%%% %%% %%% %%%%%%%%%%% %%% % %%% % % %%%%% % %%%%%%% %%%%% % %%%%% % %%%%% %
%%%%%%%%%%% % %%%   %%% %%%         %%% %%%   % %%% % %%%       %%% % % %     %%% %         %   %%% %
%%%%%%%%%%% %%%%% %%%%% %%% %%%%%%%%%%% %%% % % %%% %%%%% %%%%% %%% % % % %%%%%%% %%% %%% %%% % %%% %
%%%%%%%     %%%%%       %%% %       %%%     %   %%%     % %%%     % % %     %%%%%     %%% %%% % %   %
%%%%%%% % %%%%%%%%% %%% %%% % %%%%% %%% % %%% %%%%%%% %%% %%%%%%%%% % %%%%% %%%%% %%% %%%%%%%%% %%% %
% %     % %     %%% %%% %%%   %%%%%   % % %%% %%%%%%%     % %%%%%%% % %%%%% %%%   %%%   %%%%%   %%% %
% % %%% % % %%% %%%%%%% %%% %%%%%%%%% % % %%% %%%%%%%%% %%% %%%%%%% % %%%%%%%%%%%%%%%%% %%%%% %%%%%%%
%   %%% %   %%%   %%%   %%% %     %%%   % %%% %%%%%%%%%     %   %   %         %%%%% %%% %%%%% %%% %%%
%%%%%%% %%%%%%%%% %%%%% %%%%% %%% %%%%%%% %%%%%%%%%%%%% %%%%% % % %%%%%%%%%%% %%%%% %%% %%%%% %%% %%%
%%%%% % %%%%%%%   %%%%% %%%%% %%%       %   %%% %%%%%   %     %   %%% %%% %   %%%   %%% %     %%%   %
%%%%% % %%%%%%% % %%%%% %%%%% %%% %%%%% %%%%%%% %%%%% %%% %%% %%%%%%% %%% % %%%%%%% %%%%% %%%%%%%%% %
% %%% %       % % %%%       %  S% %%%%% %       % %%%   % %%% %%%       %     %%%%%   %%%     %%%%% %
% %%% %%% %%% % %%%%% %%%%% %%%%%%%%%%% % %%%%% % %%%%% % %%%%%%% %%%%% % %%% %%%%% %%%%% %%% %%%%% %
% %%% %   %%% %         %%% %%%%%%%%%   % %%%%%     %%% %   %%%%% %%%%%   %%% %%%   %%%%% %%%       %
% %%% % %%%%% %%%%% %%% %%%%%%%%%%%%%%% % %%%%%%%%% %%%%% %%%%%%%%%%%%% %%%%% %%% %%%%%%%%%%% %%%%% %
%       %%% % %%%%% %%%   %%%%%%%%% %%%   %%% %%%%%       %%%%% %%%       %%% %     %%%%%%%   %%%%% %
% %%% %%%%% % %%%%%%%%% % %%%%%%%%% %%%%%%%%% %%%%% %%%%%%%%%%% %%%%%%%%%%%%% %%% % %%%%%%% %%%%%%% %
% %%%   %%%   %%%%%%%   %   %%%%%     %         %%% %%%           %%%%%%%%% %   % % %%%%%%% %%%%% % %
% %%%%% %%% %%%%%%%%% %%%%% %%%%% %%% %%% %%%%%%%%%%%%%%% % %%%%% %%%%%%%%% %%% %%% %%%%%%% %%%%% % %
%   %%% %%% %%%%%%%       %       %       %%%%%%%%%%%%%%% % %%%   %           %     %   %%%   %%%   %
% %%%%%%%%%%%%%%%%%%%%%%%%%%% % %%%%%%%%%%%%%%%%%%%%%%%%% %%%%%%% % %%%%%%% % %%%%% % % %%% % %%%%%%%
% %%% %%% %%%     %%%%%%%%%%% %     %%%%%%%%%%%%%%%%%%%%%   %   % % %%%%%%% % %%%%% % % %   % %%%%%%%
%%%%% %%% %%%%%%% %%%%%%%%%%%%%%%%% %%%%%%%%%%%%%%%%%%%%% % % % %%% %%%%%%%%% %%%%% %%% % %%% %%%%%%%
%%%             %             %         %%% %%%%%%%%%%%   %   % %%% % %%%%%%% %%%%% %%%   %%%     % %
%%%%% %%% %%%%% % %%% %%%%%%% % %%%%%%% %%% %%%%%%%%%%%%% %%% % %%% % %%%%%%% %%%%% %%% %%%%% %%% % %
% %%%   %   %%%   %%% %%%%%%%   %%% %%% %   %%% %%%%% %%% %%% %     %   %%%%%       %%% %%%   %%%   %
% %%%%%%%%% %%%%%%%%%%%%%%%%% %%%%% %%% % %%%%% %%%%% %%%%%%% %%%%%%% %%%%%%%%%%%%%%%%%%%%% % %%%%%%%
%   %%%%%%%   %         % %   %%%   %   % %%%%%   %%% %%%%% %         %%%%% %%% %%%   %%%   %     %%%
% %%%%%%%%% % % %%%%%%% % % %%%%% %%% %%% %%%%%%% %%% %%%%% %%%%%%% %%%%%%% %%% %%% % %%%%% %%% % %%%
%         % %       %%% %   %%%%%             %%%     %         %%% %%%             %   %%% %%% % %%%
% %%%%% %%% %%%%%%%%%%% %%%%%%%%%%%%%%%%%%%%%%%%% %%%%% %%%%%%% %%% %%%%%%%%%%%%% %%%%%%%%%%%%%%% %%%
% %%% %     % %%%%%%%%%     %%% %%%%%                     %%%%%     %             %%%%%%% %%%       %
% %%% %%%%% % %%%%%%%%%%%%% %%% %%%%% %%%%%%%%%%% %%%%%%%%%%%%%%%%%%% %%%%%%%%%%% %%%%%%% %%% %%%%% %
%       %%% %   %%% %%%%%%%       %   %%% %%%%%%%   %%% %%% %%%       %   %%%%% %   %             % %
% %%% %%%%% %%% %%% %%%%%%% %%%%% % %%%%% %%%%%%% %%%%% %%% %%% %%%%%%% % %%%%% %%% % %%%%% %%% % %%%
% %%% %%%%%     %%%         %%%   %         %%%%% %%%     %     %%% %%% %   %%% %%% % %%%%% %%% % %%%
%%%%%%%%%%%%% %%%%% %%% %%% %%%%% %%%%%%%%% %%%%%%%%% % % %%% %%%%% %%% %%%%%%% %%% %%%%%%% %%%%% %%%
%%%%%%%   %%% %%%   %%% %%%   %%%   % %%%%% %%%%%%%   % % %%% %%%%% %%%   %%%   %   %%% %%%   %     %
%%%%%%% %%%%%%%%% % %%%%%%% %%%%%%% % %%%%% %%%%%%%%%%% % %%% %%%%% %%% % %%% % % %%%%% %%%%%%% %%% %
%%%%%%% %%% %%%%% % %%%%%   %%% %%%     %%%   %%%%%     % %   %%%%% %   %     %   % %%%   %%%%% %   %
%%%%%%% %%% %%%%%%% %%%%%%%%%%% %%% %%%%%%% %%%%%%% %%%%% %%% %%%%% % %%%%%%%%%%%%% %%% % %%%%% % %%%
%       %%%   %%%%%     %%%       % %%%     %%%%%%%   %%%     %   %     % %%% %%%       % %     % %%%
% %%% %%%%% % %%%%%%% %%%%% %%%%% % %%% %%%%%%%%%%% % %%%%% %%% % % %%% % %%% %%% % %%%%% % %%%%% %%%
% %   %%%   %     %%%       %%%   %   % % %%% %%%   %   %%% %%% %   %%%           % %%%   % %%%     %
% %%% %%%%% %%%%% %%% %%%%%%%%% %%%%% % % %%% %%%%%%%%% %%% %%%%% %%%%% %%%%% %%%%% %%%%% % %%%%%%% %
% %%%   %%%   %%% %%% %%%%%%%   %%%%% % %     %%%%%%%%% %     %%% %%%%% %%%   %%%     %%%     %%%%% %
% %%%%%%%%% %%%%% %%%%%%%%%%% % %%%%%%% %%%%% %%%%%%%%% %%% %%%%%%%%%%%%%%% %%%%% %%%%%%%%% %%%%%%% %
% %%%%%%%   %%%%%   %%%%%%%   %     %   %%%     % %%%%% %%% %%% %%%%%%%%%     %%% %%%%%%%   %%% %%% %
% %%%%%%% %%%%%%%%% %%%%%%% %%%%% %%% %%%%% %%% % %%%%% %%%%%%% %%%%%%%%% %%% %%% %%%%%%% %%%%% %%%%%
%         %%%%%%%   %%%%%   %%% %   %   %%% % % %         %%%%%   %%%%% % %%% %%% %%%%%   %%%   %%%%%
% %%%%% %%%%%%%%% % %%%%% %%%%% %%% % %%%%% % % % %%%%% %%%%%%% %%%%%%% % %%%%%%%%%%%%% %%%%%%% %%%%%
%   %%% %%%%%%%   % %%%%% %%%     %   %%%   %     %%%%% %%%     %%%   %     %%%%%%%%%%% %%% %%% %%%%%
% %%%%% %%%%%%%%% %%%%%%% %%%%%%% %%%%%%% %%% %%%%%%%%%%%%% %%% %%% %%% %%%%%%%%%%%%%%% %%% %%% %%%%%
% %%%   %     %%% %%%     % %%%     %%%%% %%% %%%   %%%%%%% %%% %       %%%%%     %%% % %%%       %%%
% %%% %%%%%%% %%% %%% %%%%% %%% %%% %%%%% %%%%%%% % %%%%%%% %%%%% %%%%%%%%%%%%% % %%% % %%% %%% %%%%%
% %%%       %   %     %     %%% %%% %%%%% %%%%%   % %%%       %   %%%       %%% %   %   %%%   %   %%%
%%%%%%% %%% %%% %%%%%%% %%% %%% %%%%%%%%% %%%%% %%% %%%%% % %%% %%%%% %%% %%%%%%% %%% %%%%%%%%% % %%%
%%% %%% %%%   % %%%     %%%       %%%%%%% %   % %%%       % %%% %%%   %%% %%%%%%%   %     %%%%% % %%%
%%% %%%%%%%%% % %%% %%%%%%% %%%%% %%%%%%% % %%% %%% %%%%% %%%%% %%%%% %%%%%%%%%%% % % %%%%%%%%%%% %%%
%     %%% %%%   %     %   %   %           %     % %   % % %%% %   %   %%%%%%%   % %   %%%%%%%       %
% %%%%%%% %%%%% %%% %%% % %%% %%%%%%%%% %%% %%%%% %%% % % %%% %%% % %%%%%%%%% % % %%%%%%%%%%% %%%%% %
% %%%%%   %%%   %%% %%% %   % %%%%%%%%% %%% %%%%% %%% %       %   % %%%   %%% %   %%%%%   %%% %%% % %
% %%%%% %%%%%%% %%%%%%% %%% % %%%%%%%%%%%%% %%%%% %%% %%%%% %%% %%% %%% %%%%%%% %%%%%%% %%%%% %%% % %
% %%%   %   %%% %       %%% % %%%     %%%   %       % %%%%% %%%   % %   %%%%%%% %%% %%%       %   % %
% %%% %%% % %%% % %%%%%%%%% % %%%%%%% %%% %%%%% % % % %%%%%%%%%%% % % % %%%%%%% %%% %%%%%%% %%% %%% %
%     %   %     %     %%%     %%%%%   %%%     % % % % %   %       %   %   %%% %             %%%     %
% %%%%% %%%%% %%%%%%% %%%%%%% %%%%% %%%%%%%%% %%% %%% % % % %%%%%%%%%%%%% %%% %%%%%%%%%%%%% %%% %%%%%
%   %%%   %%%   %%%%%   %%%%%     % %%%%%         %%%   %     %%%         %%%     %         %%%   %%%
% % %%% %%%%%%% %%%%% %%%%%%%%%%% % %%%%%%% %%% %%%%% %%%%%%%%%%%%% %%%%%%%%% %%%%% %%%%% %%%%%%%%%%%
% % %%% %%%%%%%   %%%       %%% %   %   %%% %%% %%%   %%%   %%%%%   %%%%%%%%% %%%%% %%%%%     %%%%% %
%%% %%% %%%%%%%%% %%%%% %%% %%% %%% % % %%% %%%%%%%%% %%% % %%%%% %%%%%%%%%%% %%%%% %%%%% %%% %%%%% %
%%%     %%%%%%%%%       %%% %%%       % %%%   %%%%%%%     %       %%%%%%%%%%%         %%% %%%       %
%%%%%%%%%%%%%%%%%%%%%%%%%%%%%%%%%%%%%%%%%%%%%%%%%%%%%%%%%%%%%%%%%%%%%%%%%%%%%%%%%%%%%%%%%%%%%%%%%%%%%
