%%%%%%%%%%%%%%%%%%%%%%%%%%%%%%%%%%%%%%%%%%%%%%%%%%%%%%%%%%%%%%%%%%%%%%%%%%%%%%%%%%%%%%%%%%%%%%%%%%%%%
%%%%%     %   %%% %%%%%%%%%%%%%       %%%%%%%         %%%%%   %%%       %   %%%   %%% %%%       %%% %
%%%%% %%% % % %%% %%%%%%%%%%%%% %%%%% %%%%%%%%% % %%%%%%%%% %%%%% %%%%% % % %%%%% %%% %%% %%%%% %%% %
%     %%%   %     %%%%%%%%%   %   %%% %%%%% %%% % %%%%%%%%% %%%%%   %%%   %   %%%       % %%%     % %
%%% %%%%%%%%%%% %%%%%%%%%%%%% % %%%%% %%%%% %%% %%%%%%%%%%% %%%%%%%%%%% %%%%% %%% %%% %%% %%% %%% % %
%   %           %%% %%%%% %%%   %%%%%         %       %         %%%%%%% %%%%% %%% % % %%% %%%   %   %
% %%% %%%%%%% %%%%% %%%%% %%%%% %%%%% %%%%% %%% %%%%% % %%% %%% %%%%%%% %%%%% %%% % % %%% %%%%% %%%%%
% %     %%%%% %%%         %%%%%   %%% %%%   %%%   %%%   %%%   % %       %%%     %   %         % %%%%%
% % %%%%%%%%% %%%%% %%% % %%%%%%% %%%%%%% %%%%% %%%%%%% %%%%% %%% %%%%% %%%%% %%%%% %%%%% %%% % %%%%%
% %   %%%   % %%%%%   % %     %%%   %%%%%       %%%%%%% %   %     % %%% %     %%% % %%%%% %%% %     %
% %%%%%%% % %%%%%%%%%%% %%%%% %%%%% %%%%%%%%% %%%%%%%%% %%% %%% %%% %%%%% %%%%%%% % %%%%%%%%%%% %%% %
%         % %%%   %%%%%     % %%%   %%%   %%%   %%%%%%%     %%%     % %%%           %       %%% %   %
% %%%%%%% % %%%%% %%%%% %%% %%%%% %%%%% %%%%% %%%%%%%%% %%% %%%%%%% % %%%%%%%%% %%%%% %%%%% %%%%% % %
%   %%%%% %   %%%   %%% %%%     % %     %%%%% %%%%%%%%% %%% %%%%%         %%%%%   %%%   %%% %%%%% % %
%%% %%%%%%% %%%%%%% %%% %%%%% % % %%% % %%%%%%%%%%%%%%% %%%%%%%%% %%%%%%% %%%%%%%%%%%%% %%% %%%%% %%%
% %   %     %%%%%%%   % % %%% %     % % %   %%%   %%%%%   %%% %%% %%%     % %%%%%       %%%       %%%
% % %%% % %%%%%%%%%%% % % %%% %%%%% % % %%% %%% %%%%%%%%% %%% %%% %%%%% %%% %%%%% %%%%%%%%%%%%%%% %%%
%   %   % %%%%%%%%%%%     %%%   %%%   % %%%   %       %%%     %%%   %%%   % %%%   %   %%% %%% %   % %
%%%%% %%%%%%%%%%%%%%%%%%%%%%%%%%%%%%%%% %%% %%% %%% %%%%%%%%%%%%%%%%%%%%% % %%%%% %%% %%% %%% % %%% %
%%%%% %   %%%%%%%%% %%%%%%% %%%%%%% %   %       %%%     %%%%%%%%%%%%%     %   %%% %%%           %   %
%%%%% % % %%%%%%%%% %%%%%%% %%%%%%% % %%%%% %%%%%%% %%% %%%%%%%%%%%%% %%% % %%%%% %%%%% %%%%%%% %%% %
%     % %   %%%%%%% %%%       %       %%%%%     %%% % %         %%%   %%%   %%%   %%%%% %%%%%%%   % %
% % %%% %%% %%%%%%% %%% %%% %%% %%%%%%%%%%%%% %%%%% % %%% %%%%% %%%%%%%%% %%%%% %%%%%%% %%%%%%%%% % %
% % %%% %%%   %%%%% %%% %%% %%% %   %%% %%%%% %%%   %   %   %%% %%%%%%%   %%%%%       %   %%%       %
% %%%%% %%% %%%%%%% %%% %%%%%%% %%% %%% %%%%%%%%% %%% %%%%% %%%%%%%%%%%%%%%%%%% %%%%% %%%%%%% %%%%%%%
%       %%%         %%% %%%%%     %   %     %%% %     %%%%%   %%% %%%         % %%%%% %%%%%   %%%%%%%
%%% %%%%%%%%% %%%%% %%% %%%%%%%%% % %%% %%% %%% % %%% %%%%% %%%%% %%% %%%%%%% %%%%%%% %%%%%%%%%%%%%%%
%%%   %%%%%%% %%%%% %%%     %%% % %     %%%       %%% %%%   %%%   %%% %%% %%% %     %     %%%%%     %
%%%%%%%%%%%%%%%%%%% %%% %%% %%% % %%% %%%%% %%%%%%%%% %%% %%%%%%% %%% %%% %%% % %%% %%%%% %%%%%%%%% %
%%%%%%%     %%%         %%%       %%% %%%%% %%%%%%%   %%% %%%%%%%     %         % %   %%%   % %%%%% %
%%%%%%% %%%%%%% %%% %%%%%%%%%%%%% %%%%%%%%%%%%%%%%%%%%%%% %%%%%%% %%%%% %%%%%%%%% %%% %%% % % %%%%% %
%%%%%%% %   %   %%% %         %%% %%%%%%%   %   %%%%%%%         % %%%     %%%%%     % %%% %   %%%%% %
%%%%%%% % % % %%%%% %%%%%%% % %%% %%%%%%% % % %%%%%%%%% %%% %%%%% %%% %%%%%%%%% %%% % %%% %%%%%%%%% %
%%% %%%   %   %%%   %%%     % %%% %   %%% %   %%%   %   %   %%%%% %%% %%%%%     %%% % %     %%%%%%% %
%%% %%%%%%% %%%%%%% %%% %%%%% %%% %%% %%% %%% %%% % % %%% %%%%%%% %%%%%%%%% %%% %%%%% %%% % %%%%%%% %
%     %%%%% %%%%%%% %   %%%%% %%% %%% %   %%%     %   %   %%%       %%%%%%% %%%   %%% %%% %         %
% %%%%%%%%%%%%%%%%% % % %%%%%%%%% %%% % % %%% %%% %%% %%%%%%% %%% %%%%%%%%% %%% % %%% %%%%%%% %%%%% %
%   %%%%%%%%%%%%%     %     %%%   %     % % % %%% %%% %       %   %%%%%     %%% %     %%%%%%% %%%   %
% % %%%%%%%%%%%%%%% %%%%%%%%%%% %%%%%%%%% % % %%% %%%%% %%% %%%%%%%%%%%%% %%%%%%%%% %%%%%%%%% %%%%% %
% %   %%%%% %   %%% %     %%% % % %%%     %   %%% %     %%% %%%%%%%   %%%     %%%%% % %%%     %%%%% %
%%%%% %%%%% % % %%% % %%% %%% % % %%% %%%%% %%%%%%% %%%%%%%%%%%%%%% %%%%% %%%%%%%%% % %%%%%%% %%%%%%%
%%%     %%% % %     % %%% %%%         %   % %   %%%   %%%%%%%       %%% % %%%%%     %   %%%%%   %%%%%
%%% % %%%%% % %%%%% % %%% %%%%% %%% %%% % % %%% %%%%% %%%%%%%%% %%% %%% % %%%%% %%% %%% %%%%% %%%%%%%
%%% % %     % % %%% % % %     % %%% %%% %   %%%   %%%   %   %%% %%%     % %%%   %%%     %     %%% %%%
%%% %%% %%% % % %%% % % %%%%% %%%%%%%%% %%% %%%%% %%% %%% % %%% %%% % %%% %%% %%%%%%%%% % %%%%%%% %%%
%%%   % %%%     %%% %   %%%   %%%     % %%%   %%% %%% %   % %%% %%% %     %%%     %%%%%   %%%%%     %
%%% % % %%% %%% %%%%%%% %%% %%%%% %%% %%%%%%% %%% %%% % %%% %%%%%%% %%%%%%%%%%%%%%%%%%% %%%%%%% %%%%%
%%% %   %%% %%% %%%%%%%   % %S    %   %%%%%%%     %%% % %%%   %%%     %%%   %%%%%%%     %%%     %%%%%
%%%%%%%%%%%%%%%%%%%%%%% %%% %%%%%%% %%%%%%%%%%%%% %%% % %%%%% %%%%%%% %%% %%%%%%%%%%% %%%%% %%% %%%%%
%   %         %%% %%%%% %%%     %     %%%       % %%%   %   %     %%%     %       %%% %%%   %%%     %
% % % %%%%% %%%%% %%%%% %%%%% % % %%%%%%% %%% %%% %%%%%%%%% %%%%% %%% %%%%% % %%%%%%%%%%% % %%%%% %%%
% %     %%% %%%     %     %%% %   %%%%%%% %%% %   %%%       %   %   % %%%   %       %!    %   %%% %%%
% %%%%%%%%% %%%%% %%% %%%%%%% %%% %%%%%%%%%%% % %%%%% %%%%% %%% %%% %%%%% %%%%%%% % % %%% %%% %%%%%%%
% %%% %%%%%   %%% %   %%%%%%% %%%   %%% %%%   % %%%%% %%% %     %%% %     %%% %   % %   %   %   %%%%%
% %%% %%%%% %%%%% % %%%%%%%%%%%%%%%%%%% %%% %%% %%%%% %%% %%%%% %%% % %%% %%% % %%%%%%% %%% %%%%%%%%%
%         %         %%%   %%%%% %%%%%   %%%           %%% %     %%%   %%%     %   %%%%% %%% %%%%%%%%%
% %%% %%%%%%%%%%%%%%%%% % %%%%% %%%%%%% %%%%%%%%%%%%%%%%% % %%%%%%%%% %%% %%% %%% %%%%% %%% %%%%%%%%%
% %%% %%%%%%%%%   %%%   % %%%   %%%         %%%       %%%   %   %%%%% %%% %%% %%%         %   %     %
%%%%% %%%%%%%%% % %%%%% % %%%%% %%%%% %%%%% %%%%%%%%% %%% %%% % %%%%%%%%%%%%%%%%%%% %%%%%%% % % % %%%
%%%%% % %%%%%   %       %       %%%%% %%%   % %%%%%%% %%% %   %     %%%%%%%%%%% %%% %%%     % % % %%%
%%%%% % %%%%% %%%%% % %%%%% %%% %%%%% %%% %%% %%%%%%% %%% %%% %%% %%%%%%%%%%%%% %%%%%%% %%%%% % % %%%
%%%   % %%%   %%%%% % %     %%%       %%% %   %%%%%   %%% %%% %   %%% %%% %%%           %   %   %   %
%%% %%% %%%%% %%%%%%% %%% %%%%%%% %%%%%%% %%% %%%%%%% %%% %%% %%%%%%% %%% %%%%% %%%%%%% %%% %%%%% %%%
%     % %%%%% %   %%%   % %     % %%%%%   %%%     %%%         %%%%%     % %%%%%   %%%%% %%% %%%   %%%
%%%%% % %%%%%%% % %%% % % % %%% %%%%%%% %%%%% % %%%%% %%%%%%% %%%%%%% % % %%%%%%% %%%%%%%%% %%% %%%%%
%%%%%           % %%% % % % %%% %%% %%% %%%   % %%%   %%%   % % %%%   %     % %%%     %%%%%   % %%% %
%%%%%%%%%%%%%%%%% %%%%% %%% %%% %%% %%% %%% % %%%%%%% %%% %%% % %%% %%%%%%% % %%%%% %%%%%%% % % %%% %
%     %   %%%     %%%%% %%%   % %   %   %   %     %%% %%% %%%   %   %%%     % %%% % %%%     % % %   %
%%% %%% % %%% %%% %%%%% %%% %%% %%% % %%%%%%%%% % %%%%%%% %%%%% % %%%%% %%%%% %%% % %%% %%% % % %%% %
%%%     % %   %%% %%%%% %%% %%% %%% % %         % %%%%%%%         %%%%%           % %   %%% %       %
%%% %%%%% % %%%%% %%%%% %%% %%% %%% % %%% %%%%% %%%%%%%%%%% %%% %%%%%%%%%%%%%%%%%%% % %%%%% %%%%%%%%%
% % %%%%%   %%%%% %%%%%     %%%   %       %   % %%%%%   %%% %%% %%%         %     % % %%%%%     %%%%%
% % %%%%% %%%%%%% %%%%% %%%%%%% % %%%%% %%% %%% %%%%%%% %%% %%%%%%% %%%%%%% % %%% % %%%%%%%%% %%%%%%%
% % % %%%   %%%%% %%%   % %%%   % %%%   %%%         %%% %%% % %%%     %   %   %%%   %%% %     %%%   %
% % % %%% %%%%%%%%%%%%% % %%%%% % %%%%%%%%%%%%%%%%% %%% %%% % %%%%%%% % % %%%%%%%%%%%%% % %%%%%%% %%%
%   % %%% %%%   %%%%%%%   %%%%% % %%%%%%%%%%%%%%%%%     %       %%%%% % %   %%%       %   %%%       %
% %%% %%%%%%% % %%%%%%% %%%%%%% % %%%%%%%%%%%%%%%%%%%%% %%%%% %%%%%%% % %%% %%% %%%%% % %%%%%%%%%%% %
%     %%%%%%% %   %%%%% %%%%%%% %       %%% %%%%% %     %%%   %       % %%%       %%% % %%%%%       %
%%% %%%%%%%%% %%%%%%%%%%%%%%%%% %%% % %%%%% %%%%% % %%%%%%%%% % %%%%%%% %%%%% %%% %%%%% %%%%% %%%%%%%
% % %%% %%%   %%%%%   %%%       %%% % %%%                 %%% % %%%   %   %%% %%%   %%%     %   %%%%%
% % %%% %%% %%%%%%% % %%% %%%%%%%%% % %%% %%%%%%%%%%% %%% %%%%% %%%%% % %%%%% %%%%% %%%%%%% %%% %%%%%
% % %%%     %%%     %   % %     %%% % %     %%% %%%%% %%%   %%% % %%%   %%%   % %%%   %%% %     %   %
% % %%% %%% %%% %%%%%%% %%% %%% %%%%% % %%% %%% %%%%%%%%% %%%%% % %%% %%%%% %%% %%%%% %%% % %%% %%% %
%   %%% %%%     %     %     %         % %%%   % %%% %%%   %%%   % %%% %%%   %       %       %%%   % %
% %%%%% %%% %%%%% %%%%%%%%%%%%%%%%%%%%%%%%%%% % %%% %%%%% %%% %%% %%%%%%% %%% % %%% %%%%%%%%%%%%% % %
% % %%% %   %%%%% %%%%%     %%%%%%%%% %%% %%% % %%% %%%%% %%% %   %%%%%%%     % %%%   % %%%   %%%   %
% % %%%%% %%%%%%% %%%%% %%% %%%%%%%%% %%% %%% % %%% %%%%% %%% % %%%%%%%%%%%%%%% %%%%% % %%% %%%%%%%%%
%     %   %%% %%%   %   %%% %%%%%         %%%   %%% %%%%%     %   %%%   %         %%% % %%% %%% %%%%%
%%%%% % %%%%% %%% %%% %%%%% %%%%%%% %%%%% %%%%%%%%% %%%%%%% %%%%% %%%%% % %%%%% %%%%% % %%% %%% %%%%%
%%%%%   %%%%% %     % %%%%%     %   %     % %%%%%       %%% %%%%%       %   %%% %%%   %           %%%
%%%%%%%%%%%%% % %%% % %%%%% %%% % % %%%%% % %%%%% %%%%%%%%%%%%%%% %%%%%%%%% %%%%%%%%% % %%%%%%%%%%%%%
% %%% %%%       %%%   % %   %%%   % %%%%%     %%%   %%%   %%%%%   %       %   %%%%%%%   %%%%%%%%%%% %
% %%% %%% %%% %%%%% %%% % %%%%%%%%% %%%%%%%%%%%%% % %%% % %%%%% % % %%%%% % %%%%%%%%%%% %%%%%%%%%%% %
% %   %   %%%   %%%   % %     %%%%% %   %%%%%%%   %     %     % % %   %%%   %%%%%%%%%%%   %%%       %
% % % % %%%%%%%%%%%%% % %%% % %%%%%%% % %%%%%%% %%%%%%% %%% %%% % %%% %%%%% %%%%%%%%%%%%% %%% %%%%% %
%   %   %   %%%%% %     %%% %   %     %   %%%%% %%% %%%   %     %   %   %%%     %%%%%   % %%%   %   %
% %%% %%% % %%%%% % %%% %%% % %%% %%% %%% %%%%% %%% %%% %%%%%%%%% %%%%% %%%%%%% %%%%% %%% %%% %%% %%%
% %%% %%% %   %%%   %%% %%% %     %%% % %           %%% %%%%%%%%%   %%%   %%%%% %%%%% %%%   % %   %%%
%%%%% %%% %%%%%%%%%%%%% %%% %%% %%%%% % %%%%%%%%% %%%%% %%%%%%%%%%% %%%%% %%%%% %%%%% %%%%% %%% % %%%
%%%       %%%%%%%%%%%%% %%% %%% %%%%%     %%%%%   %%%     %%%%%%%%%       %%%   %%%             %   %
%%%%%%%%%%%%%%%%%%%%%%%%%%%%%%%%%%%%%%%%%%%%%%%%%%%%%%%%%%%%%%%%%%%%%%%%%%%%%%%%%%%%%%%%%%%%%%%%%%%%%
