%%%%%%%%%%%%%%%%%%%%%%%%%%%%%%%%%%%%%%%%%%%%%%%%%%%%%%%%%%%%%%%%%%%%%%%%%%%%%%%%%%%%%%%%%%%%%%%%%%%%%
%%%%%%% %%%               %%%       %%% %%%         %%%%% %%%%%%%     %%%%%     %   %%%%%%%%%%%%%%%%%
%%%%%%% %%% %%%%%%%%%%%%% %%% %%%%% %%% %%% %%%%%%% %%%%% %%%%%%%%%%% %%%%% %%% % % %%%%%%%%%%%%%%%%%
%%%%%%%     %       %%%   %%% %%%%% %   %%%   %%%%%   %%%             %%%%% %%% % %   % %%%   %%%%%%%
%%%%%%%%% %%%%% % %%%%% %%%%% %%%%% % %%%%%%% %%%%% %%%%%%%%% %%% %%%%%%%%% %%% % %%% % %%%%% %%%%%%%
%%%%% %%% %%%%% % %%%   %%%     %%%   %%%%%%%   %%% %%%%%%%%% %%% %%%       %%%   %%%   %%%   %     %
%%%%% %%% %%%%% % %%% %%%%% %%%%%%%%% %%%%%%%%% %%% %%%%%%%%% %%% %%% %%% % %%%%%%%%% %%%%% % % %%% %
% %%%     % %   %     %%%%%     %%%   %%%       %   %%%   %%%   %   % %%% %   %       %%%   %   %%% %
% %%% % %%% % %%%%%%%%%%%%%%% % %%%%%%%%% %%%%%%% %%%%%%% %%% %%%%% % %%%%% % % %%%%% %%% %%%%%%%%% %
%     % %%%     %%%%%%%   %%% %     %%%%%   % %   %   %%% %%% %%%%%   %%%%% % % %%%%%     %%%   %%% %
% %%% %%%%%%%%%%%%%%%%% % %%%%% %%% %%%%%%% % % %%%%% %%% %%% %%%%%%%%%%%%%%% %%%%%%%%%%%%%%% % %%% %
% %%% %%%%%%%%%%%%%     %   %%% %           %   %%%       %   %     %%%%%%%%% %%%%%%%%%       %     %
% %%%%%%%%%%%%%%%%% %%% %%% %%%%% % %%%%% %%% %%%%% %%%%% %%% % %%% %%%%%%%%% %%%%%%%%% %%%%%%%%%%% %
%   %%%%%%%%%%%   % %%% %%%       % %%%   %%% %%%   %%%%% %%%   %         %   % %%%%%%%   %%%   %%% %
% % %%%%%%%%%%%%% % %%% %%%%% %%% %%%%% %%%%% %%% %%%%%%% %%%%%%% %%% %%%%% %%% %%%%%%%%% %%%%% %%%%%
% %   %%%%%%%%%%%   %%%   %%%   % %%%   %%%       %%% %   %%%%%   %%% %%%%% %%%   %%%   %   %%%   %%%
% %%% %%%%%%%%%%%%%%%%%%% %%%%% %%%%%%% %%%%%%%%%%%%% % %%%%%%%%% %%% %%%%% %%% % %%% %%%%% %%%%% %%%
% %%% %%%%%%%   %%%%%   %   %%%     %%%   %%%%%         %%%   %%% %%%     % %   %       %%%    !%   %
% %%% %%%%%%% %%%%%%%%% % %%%%% % %%%%%%%%%%%%% %%%%%%%%%%%%% %%% %%%%% %%% %%%%% %%%%% %%%%%%% % %%%
% %%%   %           %%%   %%%%% % %%%     %     %%% %%%%%     %%% %%%%% %%%   %%% %%%%%   %%% % %   %
%%%%%%% % %%%%% %%% %%%%%%%%%%%%% %%% %%% %%% %%%%% %%%%% %%%%%%% %%%%%%%%%%% %%% %%%%%%% %%% % %%% %
%%%%%%%   %%%   %   %%%   %     %       % %%% % %%%       %         %%%%%   %   %     %%%       %   %
%%%%%%% %%%%% %%% %%%%% % % %%% %%% %%%%% %%% % %%%%% %%% % %%%%%%%%%%%%% % %%% %%% %%%%%%% %%%%% %%%
% %%%     %   % %   %%% %   %%% %%% %%%%% %%% %   %%% %%% % %%%%%%%     % %     %%% %%% %%%   %   %%%
% %%%%%%% % %%% %%% %%% %%%%%%% %%%%%%%%% %%% % % %%%%%%% % %%%%%%% %%% % % %%%%%%% %%% %%%%% %%% %%%
% %%%%%   % %   %%%     %%%%%             %%% % %   %%%           % %%%   % %%%%%   %     %%%   %   %
% %%%%%%%%% % %%%%%%% %%%%%%%%%%% %%% %%% %%% % %%%%%%% %%%%%%% %%% %%%%%%% %%%%%%%%% %%% %%%%% %%% %
%           %   %     %%%%%%%%%   %%% %%% %%% % %%%%%   %%%     %%% %%%%%%% %%%%%     %     %%% %%% %
%%% %%% %%% %%% % %%%%%%%%%%%%% %%%%%%%%%%%%% % %%%%%%%%%%% %%%%%%% %%%%%%%%%%%%% %%%%% %%%%%%% %%% %
%%% %%% %%% %%% % %%%   %%%%%   %%% %%% %%%%%             % %%%   % %%% %%%         %%%     %       %
%%%%%%% %%%%%%% % %%%%% %%%%% %%%%% %%% %%%%%%%%%%%%%%%%% % %%% % % %%% %%% %%%%%%%%%%% %%% %%%%% %%%
%         %%%%%         %%%   %%%%%           %%%   %     % %%% % %       % %%%%% %%%%% %%% %%%%% %%%
% %%%%%%%%%%%%%%%%%%%%% %%%%%%%%%%%%% % % %%%%%%% %%% %%%%% %%% % %%%%%%% % %%%%% %%%%%%%%% %%%%%%%%%
%       %%%   %%%         %%%%%   %%% % % %%%       % %%%       %     %%%       %     %%%   %%%%%%%%%
%%% %%% %%%%% %%%%%%%%%%%%%%%%% %%%%%%% %%%%% %%%%% % %%%%%%%%%%%%%%%%%%%%%%%%% %%% %%%%% % %%%%%%%%%
%%% %%%   %%% %%%     %%%%% %%% %%% %%%     %   %%%     %%%%%%%   %%%%% %%%   %     %%%   %   %%%%%%%
%%%%%%% %%%%% %%% %%% %%%%% %%% %%% %%% %%% % %%%%%%%%%%%%%%%%% % %%%%% %%%%% % %%%%%%% %%%%% %%%%%%%
%%%%%             %%%     %         % % %   % %%%%%%%%%%%     % % %       %%%   %%%%% %     %   %%%%%
%%%%%%%%% %%% %%%%%%% %%% % %%%%%%% % % % %%% %%%%%%%%%%% %%% % % %%%%% %%%%% %%%%%%% % %%% %%% %%%%%
%%% %%%%% %%%   %%% %   %     %%%%% %   %   %     % %%%%% %%%   % %%%%%       %%%%%     %%% %%%   %%%
%%% %%%%%%%%%%%%%%% % %%%%%%%%%%%%% %%% %%% %%%%% % %%%%% %%%%%%% %%%%%%% %%%%%%%%% %%% %%%%%%%%% %%%
%%%     %%% %%%%%     %%%   %     % %%% % % %%%   %         %%%%% %%%%%%%   %%%     %%%   %%%     %%%
%%% % %%%%% %%%%% %%%%%%% % % %%% % %%% % % %%% %%%%% %%%%%%%%%%% %%%%%%%%% %%%%%%%%%%% %%%%% %%%%%%%
%   % %%%   %%% % %%%     % % %     %%% % %     % %%%   %%%%%%% %   %%%%%%% %   %%%%%%% %%%   %%%%%%%
% %%% %%% %%%%% % %%%%%%% %%% %%%%%%%%% % %%%%%%% %%%%% %%%%%%% % %%%%%%%%%%% % %%%%%%%%%%% %%%%%%%%%
% %%%   %   %     %%%%%   %%%   %%%%%   %     %%%   %%% %%%%%   % %%% %%%%%   %     %       %%%%%%%%%
% %%%%% % % %%% %%%%%%% % %%%%% %%%%% %%%%% % %%%%% %%% %%%%% % % %%% %%%%% %%%%%%% % %%% %%%%%%%%%%%
%     %   % %%% %       % %%%   %%% % %%%%% %   %%%     % %%% %         %%% % %%%%%   %%% %%% %%%%% %
%%%%%%% %%% %%% % %%% %%% %%% %%%%% % %%%%% %%% %%% %%% % %%%%%%%%%%%%% %%% % %%%%% %%%%%%%%% %%%%% %
%%%%%%% %%% %%%   %%% %%%   % %%%     %%%     %     %       %%%%% %%%   %   %       %%% %       %%% %
%%%%%%% %%% %%% %%%%%%%%%%% % %%%%% %%%%% %%%%%%%%% %%%%% %%%%%%% %%% %%% %%%%%%% %%%%% % %%%%% %%% %
% %   %   % %   %%%     %%% %   %%%     % %%%%%     %%%%% %%%     %%%   % %%%%%%%   %%% %   %%%     %
% % % % %%% %%%%%%% %%% %%%%% %%%%%%%%% %%%%%%% %%%%%%%%%%%%% %%% %%%%% % %%%%%%%%% %%% %%% %%%%%%% %
% % %   %%% %%%     %S  %%%   %%%     %     %%%   %%%%%%%%% %   %   %%% %         %     %%%       % %
% % %%%%%%% %%% %%% %%%%%%% %%%%%%% %%%%% %%%%%%% %%%%%%%%% %%% % %%%%% %%%%% %%% %%%%%%%%% %%% %%% %
% %   %%% %     %%% %%%%%   %%%%%%%   %   %%%         %%%   %%% %       %%%%% %%%           %%% %%% %
% % %%%%% %%%%%%%%%%%%%%%%% %%%%%%%%% % %%%%% %%%%% %%%%% % %%% %%%%%%%%%%%%%%%%%%% %%%%%%%%%%%%%%% %
%   %%%       %%% %%%       %   %%%%%     %%%   %%% %%%%% % %%% %     %%%%%%%%%%%%% %     %%%%%     %
% %%%%%%% %%% %%% %%%%% %%%%% % %%%%% %%%%%%% % %%%%%%%%%%% %%% % %%% %%%%%%%%%%%%%%% %%% %%%%% %%% %
% %       %   %%%   %%% %%%   %     % % %%%   % %%%%%%%%%%%     % %     %%%%%%%%%     %%%       %%% %
% % %%%%%%%%% %%%%% %%% %%% %%%%%%%%% % %%%%% % %%%%%%%%%%%%%%% %%% %%%%%%%%%%%%% % %%%%%%%%%%%%%%% %
%   %%%%%%%%% %     %   %     %       %   %%% %       %%%%%%%%% %%% %%%%%%%%%%%%% % %   %%%   %%%   %
%%%%%%%%%%%%% % %%% %%% %%%%% % %%%%%%% %%%%%%% %%% %%%%%%%%%%% %%% %%%%%%%%%%%%% % % %%%%% % %%% %%%
%%% %%%       % % %     %%%%% % %%%%%   %%% %%% %%%     %%%       %     %%% %%%   % %       % %%%   %
%%% %%% %%%%%%% % % %%% %%%%% % %%%%% % %%% %%%%%%%%% %%%%%%%%%%% % %%% %%% %%%%%%% %%%%% %%%%%%%%% %
%       %       %   %%% %%%     %%%   %     % %%%%%%% %%% %%%%%   %   %           %     %         % %
%%%%% %%% % %%%%%%%%%%%%%%% %%%%%%%%%%% %%% % %%%%%%% %%% %%%%%%% %%%%% %%% % %%% %%% % %%%%% %%%%% %
%%%%%     % %%% %%%%%%%%%   %   %%%%%%%   %     %%%%%     %   %%%   %%% %%% %   % %%% % %%%%%   %%% %
%%%%%%%%%%%%%%% %%%%%%%%% %%%%% %%%%%%%%% %%%%% %%%%%%% % %%% %%%%% %%%%%%%%%%% % %%%%% %%%%% % %%% %
%%%   %%%%%%%%%   %%%     %%%%%       %%%     %     %%% % %%%   %     %%%       %   %%%   %%% % %%% %
%%%%% %%%%%%%%%%% %%% %%% %%%%% %%% %%%%%%%%% %%%%% %%%%% %%%%% % %%%%%%%%% %%%%% %%%%%%% %%%%% %%% %
%%%%%   %%%%%%%%% %%% %%%   %   % % %%%   %   %   %       % %%%   % %%%     %%%%% %%%     % %%% %%% %
%%%%% %%%%%%%%%%% %%% %%%%% %%% % % %%% % % %%%%% %%%%%%%%% %%% %%% %%% %%%%%%%%% %%% %%% % %%% %%% %
%%%   %%% %%%%%   %%% %%%       %   %   %   %         %%%   %%%         % %%%     %   %%%   %%%     %
%%% %%%%% %%%%% %%%%%%%%%%%%% %%% %%% %%%%%%% %%% %%% %%%%% %%%%% %%%%%%% %%% %%%%%%% %%%%% %%%%% %%%
%%%       %%%   %%%%%%%%%%%%% %%%     %%%%%%% %   %%%   %%%   %%% %%%%%%%     %%%%%%% %%%%%   %%% %%%
%%% %%%%% %%% %%%%%%%%%%%%%%%%%%%%%%%%%%%%%%% %%%%%%%%% %%% %%%%% %%%%%%%%%%% %%%%%%% %%%%%%%%%%%%%%%
%   %%%%%   %         %%%%%%%%%   % %%%       %%%%% %%%   % %%% %   %%%%%%%%%     %%% %%%%%%%%% %%%%%
% %%%%%%% %%% % %%%%%%%%%%%%%%% % % %%%%% % %%%%%%% %%%%% % %%% %%% %%%%%%%%% %%%%%%% %%%%%%%%% %%%%%
% %   %   %%% % %%%%%%% %%%%%   %   %%%   % %       %%%     %%%     %%%%%%% % %%%%%%%       %%%   %%%
% % % %%% %%% % %%%%%%% %%%%% %%% %%%%% %%%%% %%% %%%%%%% %%%%% %%%%%%%%%%% % %%%%%%% %%% %%%%% % %%%
% % %     %   %           %%% %%% %%%   %%%%% %%% %%% %%% %%%%% % %%%%%%%%%   %%%     %   %%%   %   %
%%% %%%%%%% %%%%% %%%%%%%%%%% %%%%%%%%% %%%%% %%% %%% %%% %%%%% % %%%%%%%%%%% %%%%% %%%%% %%%%%%% %%%
%%% %%%%%     %%%       %%%%%   %%% %%%   %%%   % %   %   %%%%%           %%%   %%%   %%% %     %   %
%%% %%%%% %%%%%%% %%% % %%%%%%% %%% %%% %%%%% %%% %%% % %%%%%%%%%%%%%%%%% %%%%% %%%%% %%% % %%% %%% %
%%% %%%   %%%%%   %%% %     %%%         %%%   %%%   %   %         %%% %   %%%%%     % %%%   %       %
%%% %%%%% %%%%% %%%%%%%%%%% %%% %%%%% %%%%% %%%%% % %%%%% %%%%%%% %%% % %%%%%%%%%%% % %%%%% %%%%% %%%
%   %%%%% %%%       %%%   % %%%     % %%% %   %%% %       %   %%%   %   %     %%%%% % %     %%%   %%%
% % %%%%% %%%%%%%%%%%%% % % %%%%% % % %%% %%% %%%%%%% %%%%% % %%%%% % %%% % %%%%%%% % %%%%% %%% %%%%%
% %     %   %%%%%%%%%   %     %%% % %   %       %%%%% % %%% %   % % % %   % %%%     % %%%%% %%% %%%%%
% % %%%%%%% %%%%%%%%% %%%%% %%%%%%% % %%% %%%%%%%%%%% % %%% %%% % % % % % % %%% %%%%% %%%%% %%% %%%%%
% % %%%%%   %%%     % %%%%% %%%     % %   %%%%%%%%%         %     %   % % % %%%       %%%   %%% %%%%%
% % %%%%% %%%%% %%% % %%%%%%%%% %%%%%%% %%%%%%%%%%%%%%%%%%%%% %%%%%%%%%%% %%%%%%%%%%%%%%% %%%%% %%%%%
% %   %%%       % % %     %         %%% %%%%%     %%%     %%%   %%%       %%%%%%%   %%% % %%%%% %%%%%
% % %%%%% %%% %%% % %%% %%% %%%%%%% %%% %%%%%%% % %%% %%% %%% %%%%%%% %%% %%%%%%% %%%%% % %%%%%%%%%%%
% %       %%% %%%   %%%       %%% %       % %%% %   % %%%   % %%%     %%%   %%%           %%%%%%%%%%%
% %%%%%%%%%%%%%%%%% %%%%%%%%%%%%% %%% %%% % %%%%%%% % %%%%% % %%% %%%%%%% %%%%% %%%%%%% %%%%%%%%%%%%%
%   %%%%%%%%%%%%%%%   %   %%%%%   %%% %%%     %%%%%   %%%%%       %       %%%     %%%%% %%%%%%%%%%%%%
%%% %%%%%%%%%%%%%%%%% %%% %%%%%%% %%%%%%% %%% %%%%%%% %%%%% %%%%% %%% %%% %%%%%%% %%%%%%%%%%%%%%%%%%%
%   %%%%%%%%%%%%%                   %%%   %%%     %%%   %%% %%%   %%% %%% %%%%%%%   %%%%%%%%%%%%%%%%%
%%%%%%%%%%%%%%%%%%%%%%%%%%%%%%%%%%%%%%%%%%%%%%%%%%%%%%%%%%%%%%%%%%%%%%%%%%%%%%%%%%%%%%%%%%%%%%%%%%%%%
