%%%%%%%%%%%%%%%%%%%%%%%%%%%%%%%%%%%%%%%%%%%%%%%%%%%%%%%%%%%%%%%%%%%%%%%%%%%%%%%%%%%%%%%%%%%%%%%%%%%%%
%%%%%%%%%%%%%%%%%%%%%%%%%%%%% %%%     %     %%% %     %       %%%%%%%   %%%%%   %%%%%%%%%     %     %
%%%%%%%%%%%%%%%%%%%%%%%%%%%%% %%% %%% %%% %%%%% % %%% % %%%%% %%%%%%% % %%%%% % %%%%%%%%%%% %%% % %%%
%%%%%%%%%%%%%%%%%%%%%%%%%%%%%       %   %   %%%   %%%   %%%%% %%%%%%% % %%%%% %     %%%     %%% % %%%
%%%%%%%%%%%%%%%%%%%%%%%%%%%%%%%%%%% %%% %%% %%%%%%%%% %%%%%%% %%%%%%% %%%%%%% %%% %%%%% %%%%%%% % %%%
%%%%%%%%%%%%%%%%%%%%%%%%%%%%%%%%%   %       %%%%%%%%%   %%%     %%%%% %%%     %%% %%%     %%% % % %%%
%%%%%%%%%%%%%%%%%%%%%%%%%%%%%%%%% %%%%%%%%%%%%%%%%%%%%%%%%%%%%% %%%%% %%%%% % %%% %%% %%% %%% % % %%%
%%%%%%%%%%%%%%%%%%%%%%%%%%%%%%%           %%%%% %%% %%%%% %%%%%         %%% % %   %     %       %   %
%%%%%%%%%%%%%%%%%%%%%%%%%%%%%%% %%%%%%%%% %%%%% %%% %%%%% %%%%%%% %%% %%%%% % %%% %%%%% %%% %%% % %%%
%%%%%%%%%%%%%%%%%%%%%%%%%%%%%     %%%%% % %%%   %   %%%       %   %%% %%%   % %%%   %   %%% %%% % %%%
%%%%%%%%%%%%%%%%%%%%%%%%%%%%%%%%% %%%%% % %%% %%% % %%% %%% % % % %%% %%%%%%% %%%%% %%%%%%%%%%% % %%%
%%%%%%%%%%%%%%%%%%%%%%%%%%%%%%%%%       %     %%% %     %%% %   % %%%   %%%%%     % %       %   %   %
%%%%%%%%%%%%%%%%%%%%%%%%%%%%%%%%%%%%%%% % %%%%%%% %%% %%%%% %%%%%%%%% %%%%%%% %%% % % %%%%% %%%%% %%%
%%%%%%%%%%%%%%%%%%%%%%%%%%%%%%%%%%%%%%% %   %     %%%   %%%       %%% %%%%%%% %%% %   %%%%%       %%%
%%%%%%%%%%%%%%%%%%%%%%%%%%%%%%%%%%%%%%%%% % % %%%%%%%%% %%%%% %%% %%%%%%%%%%% %%% %%%%%%%%%%% %%%%%%%
%%%%%%%%%%%%%%%%%%%%%%%%%%%%%%%%%%%%%%%%% %   %%%%%%%%% % %%%   %       %%%   %   %         % %%%%% %
%%%%%%%%%%%%%%%%%%%%%%%%%%%%%%%%%%%%%%%%%%% %%%%%%%%%%% % %%%%%%% %%% % %%%%% % %%%%% %%%%% % %%%%% %
%%%%%%%%%%%%%%%%%%%%%%%%%%%%%%%%%%%%%%%%%%% %%%%%%%%%     %%%%%%% %%% %   %%% % %%%%% %%%   %       %
%%%%%%%%%%%%%%%%%%%%%%%%%%%%%%%%%%%%%%%%%%%%%%%%%%%%%%%%%%%%%%%%%%%%% %%% %%%%% %%%%% %%%%%%%%%%% %%%
%%%%%%%%%%%%%%%%%%%%%%%%%%%%%%%%%%%%%%%%%%%%%%%%%%%%%%%           %     %   %     %%%   %%%%%   % %%%
%%%%%%%%%%%%%%%%%%%%%%%%%%%%%%%%%%%%%%%%%%%%%%%%%%%%%%% %%%%%%%%% %%%%% % % % %%%%%%% % %%%%%%% % %%%
%%%%%%%%%%%%%%%%%%%%%%%%%%%%%%%%%%%%%%%%%%%%%%% %%%         %%%%%   %   % %   %%%%%   %     %%%     %
%%%%%%%%%%%%%%%%%%%%%%%%%%%%%%%%%%%%%%%%%%%%%%% %%% %%%%%%% %%%%%%% %%%%% %%%%%%%%%%% %%% %%%%% %%% %
%%%%%%%%%%%%%%%%%%%%%%%%%%%%%%%%%%%%%%%%%%%%%     %       %   %   % %%%%% %%%     %%% %   %%%   %%% %
%%%%%%%%%%%%%%%%%%%%%%%%%%%%%%%%%%%%%%%%%%%%% %%% % %%%%%%% % % %%% %%%%% %%% %%% %%% %%%%%%% %%%%% %
%%%%%%%%%%%%%%%%%%%%%%%%%%%%%%%%%%%%%%%   %%% %%%   %%%%%%% % % %%% % %%% % %   % %%%         %%%   %
%%%%%%%%%%%%%%%%%%%%%%%%%%%%%%%%%%%%%%% % %%%%%%%%%%%%%%%%%%% % %%% % %%% % %%% % %%% %%%%%%%%%%% %%%
%%%%%%%%%%%%%%%%%%%%%%%%%%%%%%%%%%%     %   %%%%%     %     % % %%%       %     %   %     %%%%%   % %
%%%%%%%%%%%%%%%%%%%%%%%%%%%%%%%%%%%%% % %%%%%%%%% %%% % %%% % % %%%%%%% %%% %%%%% %%% %%%%%%%%%%% % %
%%%%%%%%%%%%%%%%%%%%%%%%%%%%%%%%%%%%% % %%%       %%%   %%% % % %%%   % %%% %%%%% %%% %%%%%   %%%   %
%%%%%%%%%%%%%%%%%%%%%%%%%%%%%%%%%%%%% % %%% % % %%%%%%%%%%% % % %%% %%% %%% %%%%% %%% %%%%%%% %%%%% %
%%%%%%%%%%%%%%%%%%%%%%%%%%%%%%%%%%%%% %     % % %%% %%%%%%%   %     %   %%%   %%% %   %%%     %%%%% %
%%%%%%%%%%%%%%%%%%%%%%%%%%%%%%%%%%%%%%%%%%%%% %%%%% %%%%%%%%%%% %%%%% %%%%%%%%%%% % %%%%%%% % %%%%% %
%%%%%%%%%%%%%%%%%%%%%%%%%%%%%%%%%%% %%%%%%%%%     %   %%%   %%%         %%%%%%%%%   %%%%%%% %   %   %
%%%%%%%%%%%%%%%%%%%%%%%%%%%%%%%%%%% %%%%%%%%%%% %%% % %%% % %%%%% %%%%%%%%%%%%%%%%% %%%%%%% %%% % %%%
%%%%%%%%%%%%%%%%%%%%%%%%%%%%%%%%%   %%%     %%% %%% %   % %   %%%   %%%%% %%%%%%%%%   %%%%% %%% % % %
%%%%%%%%%%%%%%%%%%%%%%%%%%%%%%%%%%% %%% % %%%%% %%% %%% % % %%%%%%%%%%%%% %%%%%%%%% %%%%%%% %%%%% % %
%%%%%%%%%%%%%%%%%%%%%%%%%%%%%%%%%S%   % % %%%   %   %%%   % %%% %     % %   %%%%%%% %%%%%     %%%   %
%%%%%%%%%%%%%%%%%%%%%%%%%%%%%%%%% % % %%% %%% %%% %%%%%%% % %%% % %%% % % % %%%%%%%%%%%%% %%%%%%%%% %
%%%%%%%%%%%%%%%%%%%%%%%%%%%         %   %         %%%%%%% %     % %   % % %   %   %%% %   %   %%%%% %
%%%%%%%%%%%%%%%%%%%%%%%%%%% %%%%%%%%%%% %%%%%%%%%%%%%%%%%%%%% %%% % %%% % % % % % %%% % % % % %%%%% %
%%%%%%%%%%%%%%%%%%%%%%%%%%% %%%%% %%% %   %%%   %%% %%%%%%%%%     % %%%   % % % %       %   %     % %
%%%%%%%%%%%%%%%%%%%%%%%%%%%%%%%%% %%% %%% %%% % %%% %%%%%%%%%%%%% % %%%%%%% % % %%%%%%% %%%%%%% %%% %
%%%%%%%%%%%%%%%%%%%%%%%%%%%%% %%%       %   % % %%%   %%%%%%%%%%% % %%%     % % %%%%%%% %%%     %%% %
%%%%%%%%%%%%%%%%%%%%%%%%%%%%% %%%%% %%% %%% % % %%%%% %%%%%%%%%%%%% %%% % %%%%% %%%%%%%%%%% % %%%%% %
%%%%%%%%%%%%%%%%%%%%%%%%%%%   %%%%% %     %   %     % %%%%%       % %   % %     %%%   %%%   % %%%   %
%%%%%%%%%%%%%%%%%%%%%%%%%%% % %%%%% %%% %%%%%%%%%%% % %%%%%%%%% % % %%% %%% %%%%%%% % %%% %%%%%%% %%%
%%%%%%%%%%%%%%%%%%%%%%%%%%% % %%%   %%% %%%%% %%% %     %       %   %%%     %%%     %   % %%%%% % % %
%%%%%%%%%%%%%%%%%%%%%%%%%%% % %%%%% %%%%%%%%% %%% %%%%% % %%%%%%%%%%%%%%%%% %%% %%%%%%% % %%%%% % % %
%%%%%%%%%%%%%%%%%%%%%%%     % %     %         %     %%%   %   %%%%%%% %%%%%     %%%%%%% % %     %   %
%%%%%%%%%%%%%%%%%%%%%%%%% %%%%% % %%% %%% %%% %%%%% %%%%%%% % %%%%%%% %%%%%%%%%%%%%%%%% % % %%% % %%%
%%%%%%%%%%%%%%%%%%%%%%%%%       %   % % %   % %       %%%   %     %%%         %%%   %   %   %%%   %%%
%%%%%%%%%%%%%%%%%%%%%%%%% %%%%%%%%% % % %%% % % % %%%%%%% % %%% %%%%% % %%%%%%%%%%% % %%%%%%%%%%%%%%%
%%%%%%%%%%%%%%%%%%%%%%%     %   %%%     %%% %   % %%%%%   % %%% %%%%% % %%%%%%%%%%%   %   %%% %%%%%%%
%%%%%%%%%%%%%%%%%%%%%%%%%%% % %%%%%%%%% %%% % %%% %%%%%%%%% %%%%%%%%% %%%%%%%%%%%%%%% %%% %%% %%%%%%%
%%%%%%%%%%%%%%%%%%%%% %%%%%   %%%%%%%   %   % %%%   % %%%%% %%%%%     %%%         %%%             %%%
%%%%%%%%%%%%%%%%%%%%% %%%%%%% %%%%%%% %%% %%%%%%%%% % %%%%% %%%%%%% %%%%% %%% % %%%%%%%%%%%%%%%%% %%%
%%%%%%%%%%% %%%%%         %%%   %%%     % %%%%%     %   %   %%%%%%% %%%   %%% %       %%%%% %%%     %
%%%%%%%%%%% %%%%% %%%%% %%%%% %%%%%%% %%% %%%%% %%%%% % % %%%%%%%%% %%% %%%%%%% %%% % %%%%% %%%%%%% %
%%%%%%%%%   %     %%%%% %%%   %%%%%%% %%%   %   %%%%% % % %%%       %%%   %%%%% %%% %   %%% %%%%%%% %
%%%%%%%%% % % %%% %%%%% %%% %%%%%%%%%%%%%%% %%% %%%%% % % %%% % % %%%%%%%%%%%%%%%%% %%%%%%% %%%%%%% %
%%%%%%%   %   % %   %%% %     %%%   %%%%%%% %%%   %   % %     % % %%%     %%%       %%%%%%% %     % %
%%%%%%% %%%%%%% %%% %%%%% %%%%%%% %%%%%%%%% %%%%% % %%% %%%%%%% % %%%%% % %%% %%%%% %%%%%%% % %%% % %
%%%%%   %         %         %%%   %%%       %%%%%   %%% %%%%%   % %%%   % %   %     % %%%   % % %   %
%%%%% %%% %%%%%%% %%%%%%% %%%%% % %%%%% % %%%%%%%%%%%%% %%%%% %%%%%%% %%% % %%% %%% % %%% % % % %%%%%
%     %   %%% %%% %%%%%%% %%%   % %%%%% %         %%%%% %     %%%%%   %%%   %%% %%%   %   % % %     %
% %%%%%%% %%% %%% %%%%%%%%%%% %%% %%%%% %%% %%%%% %%%%% % %%%%%%%%%%% %%% %%%%% %%%%% %%% %%% %%% %%%
% % %%%   %         %   %%%   %%%!%%%%% %%% %     %   % %   %%%%%%%%% %%% %%%   % %%%   %   % %   %%%
% % %%% %%% %%%%%%% % % %%%%% %%%%%%%%%%%%%%% %%%%%%% % %%% %%%%%%%%% %%%%%%% %%% %%%%% %%% % % %%%%%
% %     %%%   %%%%% % %   %%%   %%% %%%       %   %%%   %   %%%%%%%%% %%%%%     % %%% % %%% % %     %
% %%% %%%%%%%%%%%%%%% %%% %%%%% %%% %%% %%%%%%% %%%%% %%% %%%%%%%%%%% %%%%%%%%% % %%% % %%% % %%%%% %
%     %%%%%%%%%%%     %%%   %%%         % %%%   %%%   %%%     %%%%%%%   %%%%%%%   %%%       %     % %
% %%%%%%%%%%%%%%% % %%%%%%% %%% %%%%%%%%% %%% %%%%% %%%%% %%% %%%%%%% % %%%%%%%%% %%%%%%% %%%%%%% % %
% %%%%%%%         % %%% %%%     %%%       %%% %%% % %     %%%   %%%   %       %%% %%%%%%% %       % %
% %%%%%%% %%% % %%%%%%% %%%%%%%%%%% %%% %%%%% %%% % %%%%% %%%%% %%%%% %%%%% %%%%% %%%%%%% % %%%%% % %
% %%%%%%%   % % %%%         %%%%%%% %   %%%       % %%%%%   %   %%%%% %%% % %%%       %%% % %%%%%   %
%%%%%%%%%%% % %%%%% %%% %%% %%%%%%%%% % %%%%%%% %%% %%%%%%% % % %%%%% %%% % %%%%%%% %%%%% % %%%%%%% %
%%%%%%%%%%% %       %%%   % %     %%% %   %%%   %%% % %%%%% % %       %     %%%%%%% %%%   %   % %%% %
%%%%%%%%%%%%%%% %%%%%%%%%%% %%%%% %%% %%%%%%% % %%% % %%%%%%% %%%%%%%%% %%%%%%%%%%%%%%%%% %%% % %%%%%
%%%%%%%%%%%%%%%     %%%     %%%%%     %%%%%%% % %%%     % %%%   %     % %%% %%%   %%% %%%   %   %%%%%
%%%%%%%%%%%%%%% %%% %%% % %%%%%%% % %%%%%%%%% %%%%% %%% % %%%%% % %%% % %%% %%% % %%% %%%%%%% %%%%%%%
%%%%%%%%%   %%% %%% %%% % %%%     % %%%         %   %%% %   %   % %%% %   %     %   % %%%     %%%%%%%
%%%%%%%%%%% %%% %%% %%% % %%%%% %%%%%%% %%%%%%% % %%%%% % % % %%% %%% %%% % %%%%%%% % %%% %%%%%%%%%%%
%%%%%%%%%%% %   %%% %   %   %%%       %       % %   %%%   %   %%%   %     % %%% %%% % %%%   % %%%%%%%
%%%%%%%%%%% % %%%%%%% %%%%%%%%%%%%%%% %%% %%%%% % %%%%%%%%%%%%%%%%% %%%%% % %%% %%% % %%%%% % %%%%%%%
% %         % % %%%%% %%%       %%%%%     %%%%%   %%% %%%%%%%%% %%% %%%%%   %     %   %       %%%%%%%
% % %%% %%%%% % %%%%% %%% %%%%% %%%%% %%% %%%%%%%%%%% %%%%%%%%% %%% %%%%%%%%%%% % % %%% %%%%%%%%%%%%%
% % %   %     % %%% %   %   %%% %%%   %%%       % %%%       %   %%%     %%%%%%% % % %%%     %%%%%%%%%
% % % % % %%%%% %%% %%% %%% %%% %%%%% %%%%%%%%% % %%% %%%%% % % %%%%%%% %%%%%%% % % %%%%%%% %%%%%%%%%
%   % % % %%%     %   %     %%%   %%%   %%%%%     %%% % %%%   % %     %   %%%%% % %     %%% %%%%%%%%%
%%%%% % % %%% % % %%% %%%%%%%%% % %%%%%%%%%%%%%%%%%%% % %%%%%%% % %%% %%%%%%%%%%% %%% %%%%% %%%%%%%%%
%%%%% % %   % % % %   %%%%%%%%% % %%%     %%%%%%%%%%%   % %%%%%     %         %%%     %%%%% %%%%%%%%%
%%%%% %%%%% %%% % % %%%%%%%%%%% % %%% %%% %%%%%%%%%%%%% % %%%%%%%%%%%%%%%%% %%%%%%%%% %%%%% %%%%%%%%%
%%%%%   %%%     %   %%%%% %     % %%% %%%       %%%%%%%   %%% %%%%%%%     % %%%%%%%%%     % %%%%%%%%%
%%%%%%% %%%%%%%%% %%%%%%% % %%% % %%% %%%%%%%%% %%%%%%%%% %%% %%%%%%%%% % % %%%%%%%%%%%%%%% %%%%%%%%%
%%%%%%%         % %%%%%%%   %%% %     %%%%%       %   %%%       %   %%% % % %       %%%     %%%%%%%%%
%%%%%%% %%% %%%%% %%%%%%%%% %%% %%%%% %%%%% %%%%%%% % %%%%% %%% %%% %%% %%% % %%%%% %%% %%%%%%%%%%%%%
%%%%%     %       %%%%%%%%% %%% %%%%% % %%% %       %   %   %%%   % %%%   % %     % %%%     %%%%%%%%%
%%%%%%%%% %%% %%%%%%%%%%%%% %%%%%%%%% % %%% % %%%%%%% % % %%%%%%% % %%%%% % %%%%% % %%%%%%% %%%%%%%%%
%%%%%%%   %%%   %%%%%%%%%     %%%         %     %%%%% %     %%%           %       %         %%%%%%%%%
%%%%%%%%%%%%%%%%%%%%%%%%%%%%%%%%%%%%%%%%%%%%%%%%%%%%%%%%%%%%%%%%%%%%%%%%%%%%%%%%%%%%%%%%%%%%%%%%%%%%%
