%%%%%%%%%%%%%%%%%%%%%%%%%%%%%%%%%%%%%%%%%%%%%%%%%%%%%%%%%%%%%%%%%%%%%%%%%%%%%%%%%%%%%%%%%%%%%%%%%%%%%
%%%%%%%%%     %%%     %         %%%%%   %%%%%%%%%%%%%%%%%%%%% %     %%%       %%%       %%% %%%%%%%%%
%%%%%%%%% %%%%%%% % %%% %%% %%% %%%%% % %%%%%%%%%%%%%%%%%%%%% % % %%%%%%% % %%%%% % %%%%%%% %%%%%%%%%
%%%%%%%   %%%%%   % %   %%% %%%   %%% % %%%%%%%%%%%%%%%   %%%   % %%% %%% %     % %         %%% %%%%%
%%%%%%% % %%%%%%%%% % %%%%%%%%%%% %%%%% %%%%%%%%%%%%%%% % %%%%%%% %%% %%% %%%%% % %%%%% % %%%%% %%%%%
%%%%%%% %           %     %%%   % %%%%% %%%%%%%%%%%%%%% % %%%     %%%   %   %%%   % %%% %       %%%%%
%%%%%%% %%%%%%% %%%%% %%% %%% % % %%%%% %%%%%%%%%%%%%%%%% %%% % %%%%% %%%%% %%%%%%% %%% %%% %%% %%%%%
%%%     %   %%%       %%% %%% %   %%%%% %%%%%%%%%%%%%%%%% %   % %%%%% %     %       %%% %%% %%%   %%%
%%%%%%% %%% %%%%%%% %%%%%%%%% %%% %%%%% %%%%%%%%%%%%%%%%% % % %%%%%%% % %%%%%%%%%%% %%%%%%% %%% %%%%%
%%%%%%% %%%     %%% %%% %%%     %   %%% %%%%%%%%%%%%%%%     % %         %%%%%     %   %%%     %     %
%%%%%%% %%%%% % %%%%%%% %%%%%%% %%% %%% %%%%%%%%%%%%%%%%%%%%% % %%% %%% %%%%% %%% % % %%%%%%%%%%%%% %
% %%% % %   % % %%%%%%% %%%%%%% % %     %%%%%%%%%%%%%%%%%     % %%% %%%       %     % %%%           %
% %%% % % % % %%%%%%%%% %%%%%%% % %%%%% %%%%%%%%%%%%%%%%% % %%% %%%%%%%%%%%%%%% %%%%%%%%% %%%%%%%%% %
%         %   %%%%%%%%%       % %       %%%%%%%%%%%%%%%   % %%% %%%%% %%%%%     %%%%%%%%% %         %
%%%%% %%%%%%%%%%%%%%%%%%% %%% % % %%%%%%%%%%%%%%%%%%%%% %%%%%%% %%%%% %%%%%%% %%%%%%%%%%% %%% %%%%%%%
%%%%% %%%%%%%%% %%%%% %   %%%   % %%%   %%%%%%%%%%%%%%% %%%%%   %%%%% %%%%%%%   %%% %%%   %%%   % %%%
%%%%% %%%%%%%%% %%%%% % %%%%% %%% %%%%% %%%%%%%%%%%%%%% %%%%% %%%%%%% %%%%%%%%% %%% %%%%% %%%%% % %%%
%%%%% % %%%     %     %     % %%% %%%%% %%%%%%%%%%%       %   %%%%%       %%%%%       %%%   %     %%%
%%%%% % %%%%% % %%% %%%%%%% %%%%% %%%%% %%%%%%%%%%%%% %%%%% %%%%%%%%%%%%% %%%%%%%%%%%%%%% % %%%%%%%%%
% %%%   %%%   %     %%%%%%%     % %     %%%%%%%%%%%%%       %%%   %%%%%       %%%%%%%%%%% %     %%%%%
% %%% %%%%% %%% %%%%%%%%%%%%%%% % %%% % %%%%%%%%%%%%% %%%%%%%%% %%%%%%% % %%%%%%%%%%%%%%%%% %%% %%%%%
%     %%%   %   %%%%%%%%%   %   %     % % %%%%%%%       %   %%% %%%%%%% % %%%%% %%%%%%%%%%%   %     %
%%% %%%%% %%%%% %%%%%%%%%%% % %%%%%%%%% % %%%%%%%%%%%%% % %%%%% %%%%%%% %%%%%%% %%%%%%%%%%% %%% % %%%
%%%       %%%%% %%%   %%%%% %   %%%%%%%   %%%       %%%   %%%     %%%   %%%     %%%   %%%   %%% %   %
%%%%%%%%% %%%%%%%%% % %%%%% %%% %%%%%%%%% %%% %%%%% %%% %%%%% %%% %%%%% %%% %%% %%%%% %%%%%%%%% %%% %
%   %%%   % %%%%%   %       %   %%%%%%%   %   % %%% %   %%%     % %%%   %   %%%   %     %%%%%%% %%% %
%%% %%%%% % %%%%%%%%% %%% %%% %%%%%%%%% %%% %%% %%% % %%%%%%%%%%% %%% % %%% %%%%% % % %%%%%%%%%%%%% %
%   %%%%%   %%% %%%%% %%%   % %%%%%%%%% %%% %     % % %%% %%%         % %   %   %   % %%%     %%%   %
% %%%%%%%%% %%% %%%%%%%%%%% % %%%%%%%%% %%% %%% % % %%%%% %%% %%%%%%%%% % %%% %%%%%%% %%%%% %%%%% %%%
%               %       %%% %   %%%%%       %   % %           %%%       % %   %%%   % %     %%%     %
% %%% %%% %%%%% % %%%%% %%% %%% %%%%% %%%%%%% % %%%%%%%%%%%%%%%%%%%%%%% % % %%%%%%% % % % %%%%%%%%% %
% %%% %%% %%%%%   %%%%%   %   %   %%%   %%%   % %%%%%   %       %%%%%%%   %         % % % %%%%%%%   %
% %%% %%%%%%%%%%%%%%%%%%% % %%% %%%%% %%%%% %%% %%%%% % % % %%% %%%%%%%%%%%%% %%%%%%% % % %%%%%%% %%%
% %%%   %%%%%     %%%   %   %%% %%%   %%%%%   % %%%   %   % %%%   %%% %%%     %%%%%%%   % %%%     %%%
%%%%%%% %%%%% % % %%% %%%%% %%% %%%%%%%%%%% % % %%%%% %%%%% %%%%%%%%% %%% %%%%%%%%%%%%% %%%%%%%%% %%%
%%%   % % %%% % %   %       %%%   %%%%%   % % % %%%%%   %%%   %%%%%   %   %%%%% %%%     %%% %%%%%   %
%%% %%% % %%%%% %%% %%%%%%% %%%%% %%%%% % % % %%%%%%% %%%%% %%%%%%% % % % %%%%% %%% %%%%%%% %%%%%%% %
%   %     %%%%% %%% %%%%%%%   %   %%%%% % % % %%% %%% %%%           %   %   %%%       %%%   %%%%%   %
% %%% %%%%%%%%% %%% %%%%%%%%%%% %%%%%%% % % % %%% %%% %%% %%%%%%%%%%%%%%% %%%%% %%%%%%%%% % %%%%% %%%
% %%%   %%%     %%% %%%     %   %%%   % %   % %%%     %%% %%%%%         %           %%%   %       %%%
% %%% %%%%%%% % %%% %%% %%% % % %%% %%% %%%%% %%%%%%%%%%% %%%%%%% %%%%% %%%%%%% %%% %%%%% %%%%%%% %%%
%     %%%%%%% % %%%     %%%   % %%%     %%%%%   %%%%%%%     %%%%%   %%% %%%%%%% %%%   %%%   %%%%% %%%
% %%% %%%%%%% % %%%%%%%%%%%%%%% %%%%% %%%%%%%%% %%%%%%% %%%%%%%%% % %%% %%%%%%%%%%%%% %%% %%%%%%% %%%
% %%%   %%%%% %           %%%%%   %%%   % %%%%%     %%% %%%%%   % % %         %%%%%%% %%% %%%%%     %
%%%%%%%%%%%%%%%%%%%%%%%%% %%%%% %%%%%%% % %%%%%%%%% %%% %%%%% % % % %%% %%%%% %%%%%%%%%%%%%%%%% %%% %
%%%%%     %%%%%%%%%%%%%   %   % %%%   % %     %%%%% %   % %%% %   % %%% %%%%% %%%%% %%% %%%     %%% %
%%%%% %%% %%%%%%%%%%%%% %%% % % %%% %%% % %%% %%%%% % %%% %%% %%%%% %%%%%%%%%%%%%%% %%% %%%%%%% %%% %
% %     % %   %%%         % %   %%%     %   %   %   % %   %%% %%%%%     %%%     %%%       %%%%% %%% %
% % %%% % % % %%%%% %%%%% %%%%%%%%% %%% %%% %%%%% %%% % %%%%%%%%%%%%%%% %%% %%% %%% % %%% %%%%%%%%% %
%   %%% %   %   %%%   %%% %%%%%%%   %%% %%% %%%   %   %           %%%%% %%%   %   % % %%%   %%%%%%% %
% %%%%% %%%%%%% %%%%% %%% %%%%%%%%%%%%% %%% %%% %%% %%%%% %%%%% %%%%%%% %%%%% %%% % % %%%%% %%%%%%% %
% %%%     %%% % %%%%% %   %%%     %%%%%       %       %   %     %%%         %   %   %     %   %     %
% %%% %%% %%% % %%%%%%% %%%%% %%% %%%%% %%%%%%% %%%%% % %%% %%%%%%% %%%%%%% % %%% %%%%%%% %%% % %%% %
% %%%   % %%% % %%%%%%% %       %   %   %%%%%%%   %%%   %%% %%% %%% %%%%%%%   %%%       % %%% % %%% %
%%%%%%%%% %%% % %%%%%%% % %%%%%%%%% %%%%%%%%%%%%% %%%%%%%%% %%% %%% %%%%%%%%%%%%%%%%%%% % %%% %%%%% %
%%%       %     % %%%       %%%%%%%   %%% %%%     %%%%%   %   %   %         %   %%%%%   % %%% %%%   %
%%%%% %%%%% %%%%% %%%%%%%%%%%%%%%%%%% %%% %%% %%%%%%%%%%% %%% % % % %%%%%%% %%% %%%%%%%%% %%% %%% %%%
%%%   %%%   % %%%   %%%%%%%           %   %%% % %%% %%%%%     % %   %%%     %   %%%%%%%   %   %   %%%
%%% % %%%%% % %%% %%%%%%%%% %%% %%%%%%% %%%%% % %%% %%%%% %%%%%%% %%%%% %%%%% %%%%%%%%% % %%% % % %%%
%   %   %%%       %%%   %%% %%% %%%%%%%         %%%     %     %%% %%%   %%%   %%%%%%%%% % %%%   %   %
% %%% %%%%%%%%%%% %%% % %%% %%%%%%%%%%%%%%%%%%% %%%%% % %%%%% %%%%%%%%% %%% %%%%%%%%%%% %%%%% %%%%% %
%   % %%% %%% %%% %   %     %%%%% %%% %%%%%%%%%   %%% %     %       %%% %%% %%%%%%%%%       % %%%   %
%%% %%%%% %%% %%% %%% %%%%% %%%%% %%% %%%%%%%%% %%%%% %%%%% %%% %%% %%% %%% %%%%%%%%%%%%%%% % %%%%% %
%   %%%     %     %%%   %%% %%%             %   %%% % % %   %%% %%% %%% %%% %%%%%%%%%%%     %   %%% %
% %%%%%%% %%% %%%%%%% %%%%% %%%%%%%%%%% %%% % %%%%% % % % %%%%%%%%% %%% %%% %%%%%%%%%%% %%%%%%%%%%% %
% %%% %%%   %     %   %%%     %%%   %   %%% % %     % %       %%% % %         %%%%%     %%%%%%%%%   %
% %%% %%%%% %%%%% %%%%%%% %%% %%% % % %%%%%%% %%%%% % % %%%%% %%% % %%%%%%% %%%%%%% %%% %%%%%%%%%%% %
%         %           %%%   % %   %   %   %   %%%%% %S% %%%   %%% % %%% %%% %%% %%% %%%   %%%%%%%%% %
%%% %%%%% %%%%%%%%%%% %%%%%%% % %%%%%%% % % %%%%%%% %%%%%%% %%%%% % %%% %%% %%% %%% %%%%% %%%%%%%%%%%
%%% %%%%%     %%%     %%%%%%% %         %           %%%%%%%   %%%     %     %     % %%%   %%%%%%% %%%
%%%%%%%%% %%% %%% %%% %%%%%%% %%% %%%%% %%%%%%%%% %%%%%%%%%%% %%%%%%% % %%%%% %%% % %%%%% %%%%%%% %%%
%%%%%     %%%   % %%%   %%%%%   % %%%%%   %%%%%   %%%%%%%%% %     %   %   %%% %     %%%%%   %%%   %%%
%%%%%%% %%%%% % %%%%%%% %%%%%%% %%%%%%%%%%%%%%% %%%%%%%%%%% %%%%% %%% %%%%%%% %%%%% %%%%%%% %%% %%%%%
%   %%% %%%   % %%%   %   %%%%%   %%%%%%%%%%%%% %%% %%%%%%%     % %%%   %%%%%   %%% %%%%%%%     %%% %
% %%%%% %%%%%%% %%%%% %%% %%%%%%% %%%%%%%%%%%%% %%% %%%%%%% %%%%% %%%%% %%%%%%% %%% %%%%%%%%% %%%%% %
%   %   % %%%%%   %%%     % %%%     %%%     %%% %     %%%%% %%%%%   %%%   %%%%% %%%   %%%     %%%   %
% % % %%% %%%%%%% %%%%% %%% %%% %%%%%%% %%%%%%%%% % % %%%%% %%%%%%% %%%%% %%%%% %%%%%%%%%%% %%%%%%% %
% %   %   %%%%%%% %%%%% %%%     %%%%%%%     %%%   % % %%%   %     % %     %%%   %%%%%%%%%%%   %%%   %
% %%%%% % %%%%%%% %%%%% %%% %%%%%%%%%%% %%% %%% %%% %%%%%%% % %%% % % %%% %%%%% %%%%%%%%%%%%% %%% % %
% %%%%% %   %%%   % %%%     %           %%%     % %     %%%   %%% % % %%%     % %%% %%%%%%%   %   % %
% %%%%% % %%%%% % % %%%%% %%% %%%%%%%%%%%%%%%%%%% %%%%% %%% %%%%% % %%%%%%%%% % %%% %%%%%%% %%% %%% %
%!%     % %     %   %%%%% %%% % %     %%%%%%%%%   %%%%%   % % %   %     %%%     % %     %   %   %   %
% % %%%%% % %%%%%%% %%%%%%%%% % % %%% %%%%%%%%% %%%%%%% % % % % % %%%%% %%% %%%%% % %%% % %%% %%% %%%
%   %%%%% %   %       %%%%% % %   %%% %%%%%%%   %%% %   % %   % % %     % % %%%   % %   %     %   %%%
%%%%%%%%%%%%% %%%%%%%%%%%%% % %%%%%%% %%%%%%% %%%%% % % %%%%% % %%% %%%%% % %%% %%% % %%%%%%%%% %%%%%
%%%%% %%%     %             %       %     %%% %%%%%   % %%%%% % %   %%%%%   %%% %%% %   %%%   %     %
%%%%% %%% %%%%% %%%%%%% %%%%%%%%%%% %%%%% %%% %%%%% %%% %%%%% % % %%%%%%% %%%%% %%% %%% %%% %%% %%%%%
%%%%%       %%%   %%%%%   %%% %%%       %       %%% %   %%%   %   %%%     %%%%%     %%% %   %%% %%%%%
%%%%% %%% % %%%%% %%%%%%% %%% %%%%%%%%% % % %%%%%%%%% %%%%% %%%%%%%%% %%%%%%%%%%% %%%%% % % %%% %%%%%
%%%%% %%% %   %%% % %%%%%     %%%%% %   % % %     %%%   %%% %%%%%%%   %%% %%%%%%%   %%% % %     %   %
%%%%%%%%%%% % %%% % %%%%%%%%% %%%%% % %%% % % %%% %%%%% %%% %%%%%%% %%%%% %%%%%%%%% %%% % %%%%%%% %%%
%%%%%%% %%% %   %   %     %%%         %   % %   % %%%%% %     %%%   %       %%%%%%%   % % %%%   % %%%
%%%%%%% %%% %%% %%% %%%%% %%%%%%%%%%%%% % %%% %%% %%%%% % %%%%%%% %%%%% %%%%%%%%%%%%% % % %%% % % %%%
%%%%%%%     %%% %%%         %%%   %     %     %%%     % %   %%%         %%%%%%%%%%%%% % %     % %   %
%%%%%%%%%%% %%%%%%% %%% %%% %%% %%% %%%%%%%%%%%%%%% % % %%% %%% %%%%%%% %%%%%%%%%%%%% % % %%%%% % %%%
%%%%%%%%%%%   %%%   %%% %%%   %         %%%%%   %   % % %%% %   %%%%%%%   % %%%%% %   %   %%%%%   %%%
%%%%%%%%%%% %%%%% %%%%%%%%%%% %%%%% %%%%%%%%% % % %%% % %%% %%%%%%%%%%%%% % %%%%% % %%%%% %%%%%%%%%%%
%%%%%   %%%       %%%%%%%%%%%     % %%%%%   % %   %   % %%%   %%%%% %   % %   %%%     %%%     %%%%% %
%%%%%%% %%% %%%%% %%%%%%%%%%%%%%% %%%%%%% % % % %%%%%%% %%%%% %%%%% % % % % % %%%%% %%%%%%%%% %%%%% %
%%%%%%%       %%%   %%%%%%%%%%%           %   % %%%%%%%       %%%     %     %   %%% %%%%%%%         %
%%%%%%%%%%%%%%%%%%%%%%%%%%%%%%%%%%%%%%%%%%%%%%%%%%%%%%%%%%%%%%%%%%%%%%%%%%%%%%%%%%%%%%%%%%%%%%%%%%%%%
