%%%%%%%%%%%%%%%%%%%%%%%%%%%%%%%%%%%%%%%%%%%%%%%%%%%%%%%%%%%%%%%%%%%%%%%%%%%%%%%%%%%%%%%%%%%%%%%%%%%%%
%%%%%%%%%%%%%%%%%   %%%   %%%       %     %     %%%%%     %%%       %%%     %   %%%%%%%%%%%%%%%%%%%%%
%%%%%%%%%%%%%%%%%%% %%% %%%%%%% %%%%% % % %%% % %%%%% %%% %%%%% % %%%%%%% % % %%%%%%%%%%%%%%%%%%%%%%%
%%%%%%%%%%%%%%%%%       %%%     %%%%% % %   % %       %%% %%%%% % %%%     % % %%%%%%%%%%%%%%%%%%%%%%%
%%%%%%%%%%%%%%%%% %%%%%%%%%%% %%%%%%% % %%% %%% %%%%%%%%% %%%%% % %%% %%%%% % %%%%%%%%%%%%%%%%%%%%%%%
%%%%%%%%%%%         %%%%%     %%%   % % %     %   %%% %%% %%%   %   %   % %   %%%%%%%%%%%%%%%%%%%%%%%
%%%%%%%%%%% %%% %%% %%%%% %%% %%%%% % % %%%%% %%% %%% %%% %%%%% %%% %%% % %%% %%%%%%%%%%%%%%%%%%%%%%%
%%%%%%%%%%% %%% % %   %     % %%%   % %     % %   %       %%%   %%%     %       %%%%%%%%%%%%%%%%%%%%%
%%%%%%%%%%%%%%% % % %%% %%% %%%%% %%% %%%%% % % % %%% %%%%%%% %%%%%%% %%%%%%% %%%%%%%%%%%%%%%%%%%%%%%
%%%%%%%%%%%%% %   %     %%%   %%%         % %   % %%%   %%%     %%%   %%%%%%% %%%%%%%%% %%%%%%%%%%%%%
%%%%%%%%%%%%% % %%%%%%%%%%%%% %%% %%%%%%% % %%%%% %%%%%%%%%%%%% %%% %%%%%%%%% %%%%%%%%% %%%%%%%%%%%%%
%%%%%%%%%%%%% % %%%   %%%%%%%     %%% %%% % %%%   %%%%%%%%%%%%% %%% %%%%%%%     %%%     % %%%%%%%%%%%
%%%%%%%%%%%%% % %%% % %%%%%%%%%%%%%%% %%% % %%%%% %%%%%%%%%%%%% %%%%%%%%%%%%%%% %%%%% % % %%%%%%%%%%%
%%%%%%%%%%%%%     % %   %           % %%% % %%%%%   %%% %%%   %       %%%%%%% % %     %   %%%%%%%%%%%
%%%%%%%%%%%%%%%%% %%%%% % %%%%% %%% % %%%%% %%%%%%%%%%% %%%%% % %%%%% %%%%%%% % % %%%%%%% %%%%%%%%%%%
%%% %%%     %%% % %   %     %   %%%     %     %%%%%       %%%     %%% %     %   % %%%     %%%%%%%%%%%
%%% %%%%% %%%%% % % % %%%%%%% %%%%%%% %%% %%%%%%%%% %%% %%%%% %%%%%%% %%% %%% %%% %%% %%%%%%%%%%%%%%%
%%%       %%%       %       %   % %   %%%       %%% %%% %%%%% %       %%%     %   %%% %%%%%%%%%%%%%%%
%%% %%% % %%% %%%%%%% %%%%% %%% % % %%%%%%%%% %%%%% %%% %%%%%%% %%%%%%%%% %%%%% % %%%%%%%%%%%%%%%%%%%
%%%   % %   % %%%%%   %%%       %   %%%%%%%%% %%%     %   %%%   %%% %%%   %%%%% %   %%%%%%%%%%%%%%%%%
%%%%% % %%%%% %%%%% %%%%%%%%%%% %%% %%%%%%%%% %%% %%%%% % %%% % %%% %%%%% %%%%% % % %%%%%%%%%%%%%%%%%
% %%% %       %%%   %%%%%%%%%   %%% %   %%%   %%% %%%%% %     % %%% %%%%% %%%%% % % %%%%%%%%%%%%%%%%%
% %%%%% %%%%%%%%%%%%%%%%%%%%%%%%%%% % % %%%%% %%% %%%%%%% %%%%% %%% %%%%% %%%%%%% %%%%%%%%%%%%%%%%%%%
% %%%%%   %%%   %%%%%     % %%%%%%%   % % %%%   % %   %   %%%   %%% %     %%%     %%%%%%%%%%%%%%%%%%%
% %%%%%%% %%% % %%%%% %%% % %%%%%%% %%% % %%% %%% % %%% %%%%% %%%%% % %%%%%%% %%%%%%%%%%%%%%%%%%%%%%%
%   %%% %     % %%%   %   %     %%% %%%   %%% %%%   %%% %%%%% %%%             %%%%%%%%%%%%%%%%%%%%%%%
% % %%% %%%%%%% %%% %%% %%%%% %%%%% %%%%%%%%% %%% %%%%% %%%%% %%%%% %%%%%%%%% %%%%%%%%%%%%%%%%%%%%%%%
% % %%%   %%% %     % % % %%% %%%%%   %%%%%       %%% %   %%%   %%% %%% %%%     %%%%%%%%%%%%%%%%%   %
% % %%% %%%%% %%%%%%% % % %%% %%%%%%%%%%%%% %%%%% %%% %%% %%%%%%%%%%%%% %%%%%%% %%%%%%%%%%%%%%%%% %%%
% % %%%   %%% %%% %%%     %%%     %%%%%%%     %%% %%% %%%   %       %   %%%%%     %%%%%%%%%%%%%     %
%%% %%%%% %%% %%% %%%%% %%%%%%% %%%%%%%%%%%%%%%%%%%%% %%% %%% %%% % %%% %%%%% %%%%%%%%%%%%%%%%%%% % %
%%% %%%%%     %%%   %%% %%% %%% %%% %%% %%%%%%% %%%%% %%%     %%% %   %       %%%%%%% %%%%%%% %%% % %
%%% %%%%% % %%%%% %%%%% %%% %%% %%% %%% %%%%%%% %%%%% %%%%%%%%%%%%% % %%% %%% %%%%%%% %%%%%%% %%%%% %
%%% %   % %       %%%   %%% %%% %%%   %           %%% %%%%%%%%%%%%% % %%% %%% %%%       %%%   %%%%% %
%%% % % % %%% %%%%%%%%% %%% %%% %%% % %%% %%% %%% %%% %%%%%%%%%%%%% % %%%%%%%%%%% %%%%% %%%%% %%%%% %
%     %   %%%   %%%%%%% %       %   %   % %   % %     %       %%%   %   %%% %%%%% %%% %   %%% %%%   %
%%%%%%%%% %%%%% %%%%%%% % %%%%% %%% %%% %%% %%% % %%%%% %%% %%%%% %%% % %%% %%%%% %%% % %%%%% %%%%% %
%%%%%%%%%   %     %%%     %   % %   %%%     % %   %%%%% %%% %%%%% %   %   % %%%     %   %     %%%%% %
%%%%%%%%%%%%% %%% %%%%%%%%% %%% % %%%%% %%%%% % %%%%%%% %%% %%%%%%% %%%%% % %%% %%% %%%%% %%% %%%%% %
%%% %%% %%%   %%%   %%%         % %%%   %%%%% % %%%     %%%         %     %   %   %   %   %%%       %
%%% %%% %%% %%%%% %%%%%%%%% %%% % %%%%%%%%%%% % %%% %%%%%%%%%%%%%%% %%%%% % % %%% %%% % %%%%% % %%% %
%           %%%   %%%%%%%%% %%% %   %     %%%   %%%   %%%%%%%%%   % %%%%%   % %%% % %   %%%   % %%% %
% %%% % %%%%%%%%%%%%%%%%%%%%%%% % %%% %%% %%%%% %%%%% %%%%%%%%% %%% %%%%%%%%%%%%% % %%%%%%%%% %%%%%%%
% %%% % %%%%%%%%%%%%%%%%% %%%   %   % %%% % %%% %%%%% %%%%%             %%%       %       %%% %     %
%%%%%%% %%%%%%%%%%%%%%%%% %%% %%%%% % %%% % %%% %%%%% %%%%% %%% %%% %%%%%%% %%%%%%%%% %%%%%%% % %%% %
%         %%%%% %%% %%%       %%%%%   %   %     %%%%% %%%%% %%% %%% %         %%% %%%       %     % %
% %%%%%%%%%%%%% %%% %%%%% %%% %%%%%%%%% %%%%% %%%%%%% %%%%% %%%%%%%%% %%%%%%% %%% %%% %%%%% %%%%%%% %
% %   %         %%%   %%% %%% %%%       %%%%% %   %%%   %     %%%     %   %%% %%% %%% %%%     %%%   %
% % % % % %%%%%%%%%%% %%% %%%%%%%%% %%%%%%%%% % % %%%%% %%%%%%%%%%% %%% % %%%%%%% %%%%%%% %%% %%% %%%
%   %   % %%%%%%%%%%% %%%   %%%%%%%   %%%%%%%   %   %%%   %     %%% %%% %   %%%     %%%%% % %!  % %%%
% %%%%% % %%%%%%%%%%% %%% %%%%%%%%%%% %%%%%%%%%%%%% %%%%% % %%% %%% %%% %%% %%%%%%% %%%%% % %%% % %%%
% %%%%% %       %%%     % %%%         %%%%% %%% %%%   %%%   %%%   % %%% %%%           %%% % %%% %   %
%%%%%%% %%%%% %%%%%%%%% % %%%%% % %%%%%%%%% %%% %%% %%%%% %%%%% % % %%% %%%%%%%%%%%%% %%% % %%% % %%%
%%%     %%% % %%%%%%%%%   %%%   % %%%%%     %%% %   %%%   %%% % % % %   %%%%%%%       %   %     % %%%
%%%%%%% %%% % %%%%%%%%% %%%%% %%% %%%%% %%% %%% % %%%%%%% %%% % %%% % % %%%%%%% %%% %%% % %%% %%% %%%
% %%%%%     %   %%%     %     %%%   %%% %   %%%   %%%%%%%   % %       % %%%     %%% %   % %%% %%%   %
% %%%%%%%%% %%% %%% %%%%%%%%% %%% %%%%%%% % %%% %%%%%%%%%%% % %%%%% %%%%%%% %%%%%%% % % %%%%%%%%%%% %
% %%% %%%     %     %   %%%%% %   %%%     % %%% %     %%%     %%%%% %%%%%%% %%%%%%%   % %%% %%%     %
% %%% %%% %%%%% %%% %%% %%%%% %%% %%% %%%%% %%% % %%% %%%%%%%%%%%%%%%%%%%%%%%%%%%%%%%%%%%%% %%% %%% %
%       %   %%% %%% %%% %%%   %%% %%%   %   %%%   %%% % %%%%%%%   %%%%%%%%%%%%%%%%%   %%%       %   %
% %%%%% %%% %%%%%%%%%%% %%% % %%%%%%% % %%%%%%%%% %%% % %%%%%%%%% %%%%%%%%%%%%%%%%% % %%% % %%%%% %%%
% % %%% %   % %%% %%%       %   %%%   % %%%%%     %%%     %%% %%% %%%%%%%%%%%%%%%%%S% % % %   %%%   %
% % %%% % %%% %%% %%%%% %%%%%%%%%%%%%%% %%%%% %%%%%%%%%%%%%%% %%% %%%%%%%%%%%%%%%%%%% % % %%% %%% %%%
% %   %     % %%%   %   %%%%%%%%%%%%%%%   %%% %     %%%%%%%   %%%     %%%%%%%%%%%%%   % % %   %%% %%%
% % % %%%%% % %%% % % % %%%%%%%%%%%%%%%%% %%% %%% % %%%%%%%%% %%% %%% %%%%%%%%%%%%% %%% % % %%%%%%%%%
%   % %%%   %     %   % %%%   %%%%%         %   % %   %   %%%     %%% %%%%%%%%%     %%%   % %%%%%%% %
%%%%% %%%%% %%% %%%%%%%%%%% % %%%%%%%%% %%% %%% % %%% %%% %%%%%%% %%%%%%%%%%%%% %%%%%%%%%%% %%%%%%% %
%%%%% %%%%% %%% %%%%% %%%   % %%%       %%%   % % %   %       %     %%%%%%%%%%%   %   %%%   %       %
%%%%%%%%%%% %%% %%%%% %%% % %%%%% %%%%%%%%%%%%% % % %%% %%%%% % % %%%%%%%%%%%%%%% %%% %%% %%% %%% %%%
%   %%% %%%     %%%%%     %       %%%   %   %%%   %     %%%     % %%% %%%%%   %%% %     % %%%   % %%%
%%% %%% %%%%%%%%%%%%%%%%%%%%% % %%%%% % % % %%%%%%%%%%% %%%%% %%%%%%% %%%%% %%%%% % %%% % %%%%%%% %%%
%   %         %%%     %     % % %%% % %   %         %%%   %%% %%%%%%%       %%% %   %%%     %%%     %
% %%% %%% %%%%%%%%% % % %%% % %%%%% % %%% %%%%% %%%%%%%%% %%%%%%%%%%%%% %%%%%%% %%%%%%%%%%%%%%% % %%%
%     %%%   %%%     %   %%%   %%%     %%% %   %       %%% %%%%% %%% %%%     %%%   %%%   %%%%%   % %%%
% %%%%%%%%% %%% % %%%%% %%% %%%%% %%%%%%%%% % %%% %%% %%% %%%%% %%% %%%%%%% %%% %%%%% % %%%%% %%%%%%%
%   %%%%%%%     % %%%%% %%% %%%   %%%%% %   % %%% %%%   %     %     %%%         %%%   %     %   %%% %
% %%%%%%%%% %%% %%%%%%% %%%%%%% %%%%%%% % %%% %%%%%%% %%%%%%% %%% %%%%% %%%%%%% %%% %%%%%%% %%% %%% %
% %%%%%%%   %   %%%   % %%%     %       % %%%         %%%   % %%% %     % %%% %     %%%%% % %%% %%% %
% %%%%%%% %%% %%%%%%% % %%% %%%%%%% %%%%% %%%%% %%% %%%%% % % %%% % %%% % %%% %%%%%%%%%%% % %%% %%% %
% %%%%%%% %%%   %%%%%   %   %%%     %%%%%   %%% %%% %%%   % %   %     % %       %%%%%%%%%         % %
%%%%%%%%% %%%%% %%%%% %%% %%%%%%% %%%%%%%%% %%%%%%%%%%% %%%%%%% %%%%%%% % %%% %%%%%%%%%%%%%%%%%%% % %
%%%%%%%       %   %%% %%%     %%%     %       %%% %%%   %%%%% %   %%%%% % %%% %%%   %%% %%%%%   %   %
%%%%%%% %%%%%%% % %%% %%%%%%% %%%%% % % %%%%% %%% %%% % %%%%% %%% %%%%% % %%%%%%% %%%%% %%%%%%% %%% %
% %%%%% % %%%   % %%%   %%%   %%%   % % %%%     %     % %%%       %     %   %%%%%         %%%%%     %
% %%%%% % %%% %%%%%%%%% %%% %%%%% %%%%% %%%%%%% % %%% %%%%% %%%%%%% %%%%% % %%%%%%% %%% % %%%%% %%%%%
%   %%%   %%%     %%%%% %   %%%   %%%%%   %%%   % %%% %%%%%   %%%   %%%%% %   %%%%%   % % %%% %   %%%
% %%%%% %%%%%%%%% %%%%%%% %%%%% % %%%%%%% %%%%% % %%% %%%%%%% %%%%% %%%%%%%%% %%%%% %%% %%%%% %%% %%%
%   %   %%%%%   %     %   %%%   % %%%   %   %%% % %%%   %%%%%       %           %%% %%% %%%   %%%   %
% % % %%%%%%% %%%%%%% % %%%%%%% % %%% %%%%% %%%%% %%%%% %%%%%%%%%%%%% % %%%%%%% %%%%%%% %%%%% %%%%% %
% %   %%%%%       %%%   %%%%%   % %%%   %%% %     %%%%% %%%%%%% %%%   % %%%%%%%   %%%     %%%   %%% %
% %%%%%%%%%%%%% %%%%%%%%%%%%% %%% %%%%% %%% % %%% %%%%% %%%%%%% %%% %%% %%%%%%%%% %%% % %%%%% % %%% %
%       % %%%   %%%%%%% %     %%% %%%   %%%   %%%     %     %%% %%% % %       %%%   % % %     % %%% %
% %%%%% % %%% %%%%%%%%% % %%% %%%%%%% %%%%%%%%%%%%% %%% %%%%%%% %%% % %%% % %%%%%%% %%% % %%% %%%%% %
% %%%%%       %%%%%%%       % %%%%%       %%% %%%%% %%% %%%%%           % % %%%     %   %   %   %   %
%%%%%%% %%%%% %%%%%%% %%%%%%% %%%%%%%%% % %%% %%%%%%%%% %%%%% %%% %%% %%% %%%%%%%%% % %%% %%% % % %%%
%%%%%%% %%%%%   %%%   %%%%%%%       %   % %     %%%%% %       %%% %%% %   %   %%%%%   %   %%% %   %%%
%%%%%%%%%%%%%%% %%%%%%%%%%%%%%% %%% % %%% %%% %%%%%%% % %%% %%%%% %%%%% %%% % %%%%% %%% %%%%%%%%%%%%%
%%%%%%%%%%% %%%   %%%%%%%       %%%   %%%     %%%%%%% % %%% %%%%% %%%%%   % %     % %   %   %%%%%%%%%
%%%%%%%%%%% %%%%% %%%%%%%%% % %%%%% %%%%%%% %%%%%%%%% % %%% %%%%% %%%%% % % %%% % %%% %%% %%%%%%%%%%%
%%%%%%%%%                   % %%%   %%%%%%% %%%%%%%     %%% %%%   %%%   %   %%% %         %%%%%%%%%%%
%%%%%%%%%%%%%%%%%%%%%%%%%%%%%%%%%%%%%%%%%%%%%%%%%%%%%%%%%%%%%%%%%%%%%%%%%%%%%%%%%%%%%%%%%%%%%%%%%%%%%
