%%%%%%%%%%%%%%%%%%%%%%%%%%%%%%%%%%%%%%%%%%%%%%%%%%%%%%%%%%%%%%%%%%%%%%%%%%%%%%%%%%%%%%%%%%%%%%%%%%%%%
%         %%%             %%% %%%%%           % %%%%%%% %%%     %%%%% %%% %%%   %                 %%%
% %%% %%%%%%% %%%%%%% %%% %%% %%%%% % %%%%%%% % %%%%%%% %%%%% %%%%%%% %%% %%%%% % %%%%%%%%% %%% % %%%
% %%%   %%%   %%%%%%% %%%     %     %     %         %%%   %%% %%% %%% %   %%%%%   %%%     % %%% % %%%
%%%%%%% %%%%% %%%%%%%%%%%%%%% % %%%%%%%%% %%%%%%%%%%%%%%% %%% %%% %%% % % %%%%%%%%%%% %%% %%%%% %%%%%
%%% %%%   %%% %%%%%         % %   %   %%% %%%%%%%     %%%           %   % %%%   %%%   %%%   %%%     %
%%% %%% %%%%% %%%%%%% %%%%% % %%% % %%%%% %%%%%%% %%% %%% %%%%% %%%%% %%% %%% % %%% % %%%%% %%%%%%% %
% %     %         %%%     %   %%%   %%%%%   %%%%% %%%   %   %%% %%%   % %     %     %   %%%   %%%%% %
% % %%% % %%%%%%% %%%%%%% %%%%%%%%% %%%%%%% %%%%% %%%%% % %%%%% %%% %%% %%% %%%%% %%% %%%%%%% %%%%% %
%   %%%   %%%%%   %       %%%%%%%   % %%%%%     % %%%%%   %%%%%   % %   %   %%%   %%% %%% %%%   %   %
%%%%%%%%%%%%%%%%%%% %%%%%%%%%%%%% %%% %%%%%%%%% % %%%%% %%%%%%% %%% % % % %%%%%%%%%%%%%%% %%%%% % % %
%%%       %%% %%%   %%%%%%%%%%%%%     %%%     %   %%%   %%%       % % % % %%% %%%%%%%%%   %     % % %
%%% %%%%% %%% %%% % %%%%%%%%%%%%%%%%% %%%%% % %%%%%%% %%%%%%% %%% % % %%% %%% %%%%%%%%%%% % %%% % % %
%%% %         %   % %%%     %%%     % % %%% %   %%%%% %%%%%%% %%% %   %%%           % %%%   %%%   % %
%%% %%%%%%%%% %%% %%%%% %%% %%% %%%%% % %%% % %%%%%%% %%%%%%%%%%% %%% %%%%%%%%% %%% % %%%%%%%%%%%%% %
% %       %       %%%   %   %%%       %     % %%%   %       %%%     % %%%     % % %   %%%%%%% %%%%% %
% % %%%%% %%%%%%% %%% % %%%%%%% %%%%%%% %%% %%%%%%% %%%%%%% %%%%%%% % %%% %%% % % %%% %%%%%%% %%%%% %
% % %%%%% %%% %%% %%% % %%%   % %       %%% %%% %%%   %%% %   %%%   % %%% %%%   %   % %       %%%%% %
% % %%%%% %%% %%% %%% % %%% % % %%%%%%%%%%% %%% %%% % %%% % %%%%% %%% %%% %%%%%%% %%% %%% %%% %%%%% %
%       % %%%     %   % %   %   %%%%%       %%%     % %   % %%%         %     %           %     %%% %
% %%%%%%% %%%%% %%% %%% % %%%%%%%%%%% %%%%% %%%%% %%% % % % %%%%% %%%%%%%%% % % %%%%%%% %%% %%%%%%%%%
%   %%%%%   %%% %%% %%%   %   %       %%%%% %%%%% %%%   %     %%%   %%%%%%% % % %%%%%%% %%% %%%%%%%%%
%%% %%%%%%% %%% %%% %%%%%%% % %%% %%% %%%%%%%%%%%%%%% %%%%% %%%%%%%%%%%%%%%%% %%%%%%%%%%%%%%%%%%%%%%%
%       %%% %%% %%% %     % %     %     %%%%%%%%%%%   %%%%% %%%%%%%%%%%%%%%%% %%% %%%%%%% %%%   %%% %
% %%% %%%%% %%%%%%% % %%% % %%%%% %%% %%%%%%%%%%%%% %%%%%%% %%%%%%%%%%%%%%%%% %%% %%%%%%% %%%%% %%% %
% %%% %%%   %   %%%   %%% % %%%   %%% %%%%% %%%%%   %%%%%%% %%%%%   %%%%%%%       %%% %%%   %%%     %
% %%%%%%%%% % % %%%%%%%%% % %%%%% %%% %%%%% %%%%% %%%%%%%%%%%%%%% %%%%%%%%%%%%% %%%%% %%% % %%%%% %%%
% % %%% %%%   %   %%%%%%% %     % %%% %%%%%         %%%%%   %%%%%             %           % % %%% %%%
% % %%% %%%%% %%% %%%%%%% %%% % %%%%% %%%%%%% %%%%%%%%%%% % %%%%%%%%% %%% %%% %%%%%%% % %%% % %%% %%%
%   %%%   %%%   %         %%% % %%%       %%%   %%%%%     % %%% %%%%%   % %%%     %%% % %%%   %%%   %
% %%%%% %%%%% %%%%%%%%%%% %%% % %%%%%%%%% %%%%%%%%%%% %%%%% %%% %%%%%%% % %%%%%%% %%%%% %%%%%%%%% %%%
% %%%%%       %%%%%%%%%%% %%% %   %%%     %%%%%%%%%%% % %     %   %%%%% %   %%%   % %%%           %%%
%%%%%%% %%%%%%%%%%%%%%%%%%%%% % %%%%%%% %%%%%%%%%%%%% % % %%% % % %%%%%%% %%%%%%% % %%%%%%% %%% % %%%
%%%%%   %%%%% %%%%%%%%%%%%%%% % %%% %%%       %%%%% %   %   % % % %%%%%%%     %%% %   %%%%% %%% %   %
%%%%% %%%%%%% %%%%%%%%%%%%%%% % %%% %%%%%%%%% %%%%% % %%% % %%% % %%%%%%% %%% %%% %%% %%%%%%%%%%% % %
%     %%% %%%   %%%%% %%% %%% % %         %%% %       %%% %     %     %%% %%% %%% %%%       %     % %
% %%%%%%% %%% %%%%%%% %%% %%%%% % %%%%%%% %%%%% %%%%%%%%% %%%%%%%%%%% %%% %%% %%% %%%%% %%% % % %%%%%
% %%%%%       %%% %             %   %%%%%       %%%   %%%   %%%     %S%   %%%   %       %%% % % %%%%%
% %%%%% %%%%% %%% % %%%%%%% % %%%%% %%%%%%%%%%%%%%% % %%%%%%%%% %%% %%% %%%%%%% % %%%%%%%%% %%% %%%%%
%       %%%%%   %   %%%%%   % %%% % %%%     %%%%%   % % %%%%%     %   %   %   % % %%%%%%%%%   %     %
%%%%%%%%%%%%%%% %%%%%%%%% %%%%%%% % %%%%%%% %%%%%%% % % %%%%%%%%% % %%%%% % % % %%%%%%%%%%%%% % % %%%
%     %%% %%%   %%%%%%%   %%%%%%%   %%%%%%% %%% %%% %     %%%%%   %       % % %       %%% %%%   % %%%
%%% %%%%% %%% %%%%%%%%% %%%%%%%%%%% %%%%%%% %%% %%% %%%%% %%%%%%%%%%%%% %%% % %%%%%%% %%% %%%%%%% %%%
%   %       %   %%%%%%% %%% %%%%%%% %               %%%   %%% %%%%%%%%% %   %         % %       %   %
% %%% %%%%% %%% %%%%%%% %%% %%%%%%% %%% %%%%% %%% %%%%%%% %%% %%%%%%%%%%% %%%%% %%%%%%% % %%%%% %%% %
% %%% %%% %     %%%     %%%     %%%   % %%%   %%% %%% %%% %%%     %       %%%%% %%%     %     %     %
% %%% %%% %%%%%%%%% %%% %%% %%% %%%%% % %%%%%%%%%%%%% %%%%%%%%% % % %%%%% %%%%%%%%%%%%% % %%% %%% %%%
%     %   %       % %%%     %%% %%%%%   % %%%%%%%%%   %%%%%     %   %         %%%     %   %%% %%%   %
%%%%% % % % %%%%% % %%%%%%% %%% %%%%%%% % %%%%%%%%% %%%%%%% %%%%%%% %%% %%%%%%%%% %%% % %%%%%%%%%%% %
%%%%% % % %     % %   %%%   %%% %%%%% % % %%%%%%%%% %%%     %%%%%%% %%% %%%     % %%% % %       %%% %
%%%%% % % % %%% % %%% %%% %%%%% %%%%% % % %%%%%%%%% %%% % %%%%%%%%%%%%%%%%% %%% % %%% %%% %%%%% %%% %
%%%%%   % % %%% %   %   % %%%%%     %   %     %%%%% %%% % %%%%%%%%%         %%%   %%%       %   %   %
%%%%%%%%% %%%%% % %%%%% % %%%%%%% %%% %%%%% %%%%%%% %%% %%%%%%%%%%% %%%%% %%%%%%% %%% %%%%%%% % %%%%%
% %%%%%   %%%   %       % %%%%%%% %%% %%%%% %%%%%       %%% %%%%%     %%% %%%%%%% %%% %%%%%   % %%%%%
% %%%%% %%%%%%% %%% %%%%% %%%%%%% %%% %%%%% %%%%%%% %%% %%% %%%%% %%%%%%% %%%%%%%%%%% %%%%% %%% %%%%%
%   %   %   %%% %%% %%%%%   %%%   %%%       %%%%%   %%%       %%% %%%%%   %%%%% %%%%% %%%     % %   %
% %%% %%%%% %%%%%%%%%%%%%%% %%%%%%%%%%%%%%% %%%%% %%%%% %%%%%%%%% %%%%%%%%%%%%% %%%%% %%%%% % % %%% %
%   %   %%%   %%%%%%%         %%%%%%%%%%%     %%%   %   %%%%%%%   %   %%%%%     %%%%%   %%% % % %%% %
%%% % %%%%% % %%%%%%%%% %%%%%%%%%%%%%%%%% %%%%%%%%% %%%%%%%%%%% %%%%% %%%%% % %%%%%%% %%%%% % % %%% %
%%%   %%%   %   %%%%%%%   %%%%% %%%%% %%%   %%%%%%% %%%%%       %%%         % %%%%%%% %%%   % %     %
%%%%% %%%%%%%%% %%%%%%%%% %%%%% %%%%% %%%%% %%%%%%% %%%%% %%%%% %%% %%% %%%%% %%%%%%%%%%%%%%% %%% %%%
%%%%% % %%%%%         %%%   %%%     %     % % %%%%%       % %%% %%% %%% %%%     %%%%%         %   %%%
%%%%% % %%%%% %%%%%%%%%%% %%%%% % %%% % %%% % %%%%%%% %%%%% %%%%%%% %%%%%%% %%% %%%%% %%%%% %%%%%%%%%
%%%%%   %     %%%%%%%%%   %%%   % %%% %   % % %%% %%%         %%%         % %%%     % %     %%%%%%%%%
%%%%%%% %%% % %%%%%%%%% % %%%%%%% %%% %%% % % %%% %%% %%% %%%%%%%%%%%%%%% %%%%% %%%%% % %%%%%%%%%%%%%
%     %     %           %     %   %%%   % %   %     % %%% %%%%%   %       %%% % %%%%% %   %     %%%%%
% % % %%%%%%%%%%%%% %%%%% %%% % %%%%%%% % %%% % % %%% %%%%%%%%% % % %%% %%%%% % %%%%% %%%%% % %%%%%%%
% % %       %%%%%%% %%%   %%%   %%%%% % %   % % %     %%%%%%%%% %   %%% %%%%%   %%%         %     %%%
% % %%%%%%% %%%%%%%%%%% %%%%% %%%%%%% % %%% % % %%%%%%%%%%%%%%% %%%%%%%%%%%%%%% %%%%%%%%%%%%%%%%% %%%
% %   %     %%%%%%%%%%%   %%% %%%%%       %   %   %       %     %%%   %%%%%%%%%   %%%%%   %     %   %
% %%% %%%%%%%%%%%%%%%%% %%%%% %%%%%%%%%%% %%%%%%% % % %%% %%%%% %%%%% %%%%%%%%% %%%%%%% % % %%% %%% %
%   %   %%%%%   %%%%%%% %%%     %%%%%%%   %%% %%% % % %%%       %%%%% %%%%%     %%%%%   %   %%% %%%!%
% %%% % %%%%% % %%%%%%% %%%%%%%%%%%%%%%%% %%% %%% % % %%%%%%%%% %%%%% %%%%% %%%%%%%%%%% %%%%%%% %%% %
% %%% %     % % %%%       %%%%%%% %%% %%% %   %%% % %       %%% %%%%%       %   %%% %   %%%%%       %
% %%%%% %%% % %%%%% %%%%% %%%%%%% %%% %%% % % %%% %%%%%%%%% %%%%%%%%%%% %%% % % %%% % %%%%%%% %%% %%%
%   %   %     %%%   %%%%%   %%%   %       % % %   %%%     %         %%% %%% % %     % %%%%%   %%% %%%
%%% % %%% %%% %%%%% %%%%% %%%%% %%% %%%%%%% %%% %%%%% %%% % %%%%% %%%%%%%%% %%%%% %%% %%%%%%% %%%%%%%
%   % %   %%% %%%%% %%%   %%%%%     %   %%%     %%%%% %   % %%%   %%% %%%         %%%     %%%   %%% %
%%% % %%%%%%%%%%%%% %%%%% %%%%% %%%%% % %%%%%%% %%%%% %%% %%%%% %%%%% %%%%%%%%%%% %%%%%%% %%%%%%%%% %
%%% %   %%%     %%% % %%%   % %       %   %%%%% %%%   %%%   %           %%%       %%%%%%% %%%%%%%   %
%%% %%% %%% %%% %%% % %%%%% % %%%%%%% %%% %%%%% %%%%% %%%%% %%%%%%%%% % %%%%%%% %%%%%%%%% %%%%%%% % %
%   %%%     %%%       %%%%% %   %%%%% %%% %           %   %     %   % %   %%%%% %%%%% %%%         % %
% %%%%%%%%% %%%%%%%%% %%%%% % %%%%%%%%%%% %%% %%%%% %%% % %%%%% % % %%% %%%%%%% %%%%% %%%%% %%% %%% %
% %%%%%%%%% %%%%%%% %   %%%   %%%%%%%%%   %%%   %%% %   %     %   %   % %%%%%   %%%     %%%   % %%% %
% %%%%%%%%%%%%%%%%% % %%%%%%% %%%%%%%%% %%%%%%%%%%% % %%%%%%% %%%%%%% % %%%%%%%%%%%%% %%%%%%% % %%%%%
%   %%%%%%%%%%%%%%%   %%% %%%   %%%%%   %%%%%     % % %%%%% % %%%%%       %           %%% %%% % %%%%%
% %%%%%%%%%%%%%%%%%%%%%%% %%%%% %%%%%%% %%%%% %%% %%% %%%%% % %%%%%%% %%%%% %%%%%%% %%%%% %%% % %%%%%
% %%%%%%%%%%%%%%%%%%%%%%%   %%% %%%%%%% %   %   %     %           %%% %%%%% %%%%%%% %%%       % %%%%%
%%%%%%%%%%%%%%%%%%%%%%%%% % %%%%%%%%%%% % % % % %%%%% %%% %%% %%%%%%%%%%%%% %%%%%%% %%% %%%%%%% %%%%%
%%%%%%%%%%%%%%%           %   %%% %%% %   % % % %%%   %%% %%% %%%%%%%       %       %%% %%%%%%%     %
%%%%%%%%%%%%%%%%% %%%%% % %%%%%%% %%% %%%%% %%% %%%%%%%%%%%%% %%%%%%% %%%%%%% %%%%%%%%%%%%%%%%%%%%% %
%%%%%%%%%%%%%%%%% % %%% %   %%% %     %%% %       %%%%%%%%%   %%% %%%   %%%     %%%%%       %%%%%%% %
%%%%%%%%%%%%%%%%% % %%%%%%% %%% % %%% %%% %%%%% %%%%%%%%%%%%% %%% %%%%% %%%%% %%%%%%%%% %%% %%%%%%% %
%%%%%%%%%%%%%%%%%     %%%   %     %   %%%     % %%%%%%%%%%%%%     % %%%   %%% %%% %%%%% %%%     %%% %
%%%%%%%%%%%%%%%%%%%%% %%% %%% %%%%% %%%%% %%% % %%%%%%%%%%%%%%%%% % %%%%% %%% %%% %%%%% %%% %%% %%% %
%%%%%%%%%%%%%%%%%%%%% %%% %     %%% %   %   %   %%%%%%%%%%%     %   % %%% %%%         % %   %%%     %
%%%%%%%%%%%%%%%%%%%%%%%%% % %%%%%%% % % %%% %%%%%%%%%%%%%%%%%%% %%% % %%% %%%%%%%%%%% % %%%%%%%%%%% %
%%%%%%%%%%%%%%%%%%%%%%%       %%%     %         %%%%%%%%%%%%%%%           %   %         %%%%%%%%% % %
%%%%%%%%%%%%%%%%%%%%%%% %%% %%%%% %%%%% %%%%% %%%%%%%%%%%%%%%%% %%%%% %%%%% %%% %%%%%%%%%%%%%%%%% % %
%%%%%%%%%%%%%%%%%%%%%   %%% %%%     %%%   %%% %%%%%%%%%%%%%%%%%   %%% %%%           %%%%%%%%%%%     %
%%%%%%%%%%%%%%%%%%%%%%%%%%%%%%%%%%%%%%%%%%%%%%%%%%%%%%%%%%%%%%%%%%%%%%%%%%%%%%%%%%%%%%%%%%%%%%%%%%%%%
