%%%%%%%%%%%%%%%%%%%%%%%%%%%%%%%%%%%%%%%%%%%%%%%%%%%%%%%%%%%%%%%%%%%%%%%%%%%%%%%%%%%%%%%%%%%%%%%%%%%%%
% %%%%%   %%%%%   %%% %%%%%%% %%%       %%%%%%%%%%%           %%%%%%%%%%%   %%%     %%%%%     %%%%%%%
% %%%%% %%%%%%% %%%%% %%%%%%% %%% % %%% %%%%%%%%%%%%%%% %%%%% %%%%%%%%%%%%% %%%%%%% %%%%%%%%% %%%%%%%
% %%%%% %%%%%%% %%%         %   % % %%% %%%%%%%%%%%%%%% %%%       %%%   %         %   %%%%%%%     %%%
% %%%%% %%%%%%% %%% %%%%%%% %%% % % %%%%%%%%%%%%%%%%%%%%%%% %%%%% %%% %%% %%%%%%% %%% %%%%%%% %%% %%%
%       %%%%%       %%%%%%% %%%   %       %%%%% %%%%%%%     % %%%     %   %%%%%     %   %     %%% %%%
% %%% % %%%%% %%%%%%%%%%%%% %%%%%%%%%%%%% %%%%% %%%%%%% %%%%% %%%%% %%% %%%%%%% %%% % % % %%%%%%% %%%
% %%% %       %   %%%   %%% %       %%%%%       %%%%%   %%%%%       %%%     %%% %%% % %   %         %
% %%%%%%%%%%% %%% %%%%% %%% % %%%%% %%%%% %%% %%%%%%%%% %%%%% %%%%%%%%% %%% %%%%%%% %%%%%%% %%% %%% %
%   %%% %%% % %%%   %%%     % %%% %     %   %       %%%   % % %%% %%%%% %%%     %         % %%% %%% %
%%% %%% %%% % %%%%% %%% %%%%% %%% % %%% %%%%%%%%% %%%%%%% % % %%% %%%%%%%%% %%% %%%%%%%%% % %%%%%%%%%
%   %       %   %%% %   %%%     %   %%%     %%%%%         %           %%%   %%% %%% %%%       %%%%%%%
%%% % %%% %%%%% %%% % %%%%%%%%% %%%%%%%%%%% %%%%%%% %%% %%% %%%%%%%%% %%%%%%%%% %%% %%% %%%%% %%%%%%%
%%%   %%% %%%%% %         %%%%% %%%%%%%%%   %%%     %%% %%% %%%%%%%   %%%%%%%%%   %   % % %%% %%%%%%%
%%% %%%%%%%%%%% %%% %%%%% %%%%% %%%%%%%%%%% %%% %%% %%%%%%%%%%%%%%% %%%%%%%%%%% % %%% % % %%% %%%%%%%
%   %%% %%%   % %%% %%%%%   %   %%%     %%% %%%   %   %%%   %%% %%% %%% %%%%%   % %%%     %%%       %
%%% %%% %%% % % %%%%%%%%%%% %%% %%% %%%%%%% %%%%% % %%%%% % %%% %%% %%% %%%%%%%%% %%% %%% %%%%% %%% %
%%% %   %%% % %   %%% %%%%%     %           % %%% % %%%   % %%%     %   %%%%%     %%% %%%   %%% %%% %
%%% % %%%%% %%%%% %%% %%%%%%% %%% %%%%%%%%%%% %%% % %%% %%% %%%%% %%% % %%%%% % %%%%% %%% %%%%%%%%% %
%%%   %%%   %%%%%     %%% %%% %%% %               % %   %     %%% %%% %       % %%%%% %%% %%% %%%   %
%%%%% %%%%% %%%%%%%%% %%% %%%%%%% %%%%% %%%%%%% %%%%% %%%%%%% %%%%%%% %%% %%% %%%%%%% %%%%%%% %%%%%%%
%%%   %%%       %%% %       %%%         %     % %%%%%   %%%%%     %   %%% %%% %%%   %   %%%     %%%%%
%%% %%%%% %%%%% %%% %%%%%%% %%%%%%%%% %%%%%%% % %%%%%%% %%%%%%%%% % % %%% %%%%%%%%% %%% %%%%%%% %%%%%
%%% %%%%%   %         %%% %   %   %   %%%%%%%   %%% %%%   %%%   % % % %     %%% %%%   %   %%%       %
%%% %%%%% % % %%% %%% %%% % %%% % %%% %%%%%%%%%%%%% %%%%% %%% %%% %%% %%% %%%%% %%%%% %%% %%% %%% %%%
%%%   %%% % % %%% %%% %   %     % %%%   %               % %     % %%% %%% %%%   %%%   %%% %   %   %%%
%%%%% %%%%% %%%%%%%%% % % %%% %%% %%%%%%% %%%%%%%%%%% % % %%%%% % %%% %%%%%%%%% %%% % %%% %%% % %%%%%
%%%%%     % %%% %%%     % %%% %%% %%%     %%%   %%%%% % %     % % %   % %%% %%%     % %   %   %   %%%
%%%%%%%%% % %%% %%%%%%%%% %%%%%%% %%% %%% %%% %%%%%%%%% %%%%% % % % %%% %%% %%%%% %%%%% %%% %%% %%%%%
%%%%%%%   %     %%%%%   %   %%% % %%% %%% %%% %%%    !  %%%   %     %%% %%%   %%% %%%   %%% %%% %%% %
%%%%%%%%% %%% % %%%%%%% %%% %%% % %%% %%%%%%% %%% %%% %%%%% % %%%%%%%%% %%%%% %%% %%% %%%%% %%%%%%% %
%%%%%%%%%     %   %%%%%   %     %     % %%%%%   % %%% %%%   % %%%%%%%     %%%         %%%     %%%   %
%%%%%%%%%%%%% %%%%%%%%% % %%% %%% %%%%% %%%%% % % %%% %%% %%%%%%%%%%%%%%% %%% %%%%%%% %%%%% %%%%% % %
% %%%%%%%%%   %%%%%     %     %%% %%%         % % % % % %         %%%%%     %   %%%%%       %%%   % %
% %%%%%%%%% %%%%%%%%%%%%%%%%% %%% %%%%%%% %%%%%%% % % % %%% % %%%%%%%%% %%%%% %%%%%%%%%%% %%%%% % %%%
%   %%%     %%%%%%%%%%%%%%%%% %%% %%%     %%%     %     %%% %  S%%% %         %%%%%%%%%%% %%%   % %%%
% %%%%%%% %%%%%%%%%%%%%%%%%%% %%% %%% %%% %%% %%%%% %%%%%%%%%%%%%%% % %%%%%%%%%%%%%%%%%%%%%%% %%% %%%
%   %%%%% %%%   %%%   %%%%%%% %%%     % %   % %%%   %   %%%%%   %%%   %%% %       %%%%%%%%%%% %%% %%%
%%% %%%%%%%%% %%%%% % %%%%%%%%%%%%%%%%% % %%% %%% %%% % %%%%% % %%%%% %%% % %%% % %%%%%%%%%%% %%% %%%
%%%   %%%%%%% %%%%% %   %%%   %     %     %   %%% %   %       %   %%% %   % %%% % %%%%%%%       % %%%
%%%%% %%%%%%% %%%%% %%% %%% % % %%% % %%%%% %%%%%%% %%% %%%%%%% %%%%% % % % %%% %%%%%%%%% %%%%% % %%%
% %%%       %       %     % %   %%% % %%%%%           % %   %   %%%   % % %   % %%%%%%%   %%%%% % %%%
% %%%%% %%% % %%%%%%% %%% % %%%%%%% % %%%%%%% %%%%%%%%% %%% % %%%%% %%%%% %%% % %%%%%%% %%%%%%% %%%%%
%       %%% %   %   % %%%   % %     %     %%%   %     % %%%   %%%%% % %%%     %   %%%%%       % %%%%%
%%% %%%%%%% %%% % % % %%%%%%% % %%%%% %%% %%%%% % %%% % %%%%% %%%%% % %%%%%%%%% % %%%%%%%%% %%% %%%%%
%%%     %   %%% % %     %%%%%   %%%%% %%% %%%%% % %%% % %%%%% %%% %         %%% %     %     %   %%%%%
%%% %%% %%% %%% % %%%%% %%%%% %%%%%%% %%% %%%%%%% %%% % %%%%%%%%% %%%%%%%%% %%% %%%%% %%%%%%% % %%%%%
%   %%% %%%   % % %%%%%   %%% %   %%% %%%   %%%   %%% %     %%%   %%% %%%%% %   %%% % %%%%%%% %   %%%
% %%%%% %%%%% % %%%%%%%%%%%%% % %%%%% %%%%% %%% %%%%% %%% % %%%%% %%% %%%%% %%% %%% % %%%%%%% %%%%%%%
% %%%   %%%%%   %%%%%%%%%%% %   %%%   %%%%% %%% %%%       %             %%% %%% %   % %%%%%         %
%%%%% % %%%%% %%%%%%%%%%%%% %%% %%%%% %%%%%%%%% %%%%% %%%%%%%%% %%%%%%%%%%% %%% %%% % %%%%% %%%%% % %
%%%   %     % %%%   %               % %     %     %%% %%%       %%%       %     %%%       % %     % %
%%%%%%%%%%% %%%%% % % %%%%%%%%%%%%% %%% %%% % %%% %%%%%%% %%%%%%%%% %%%%% %%%%% %%% %%%%% % % %%%%% %
%%%%%       %%%   %     %%%%%%%%%%%     %%% % %%%   %%%         %%% %   %       %%% %%%   % % %%%%% %
%%%%% %%%%%%%%%%%%% %%% %%%%%%%%%%%%%%%%%%% %%%%% %%%%%%%%%%%%%%%%% % %%% %%%%% %%%%%%%%% %%% %%%%% %
%       %%%%% %%%%% %%% %%%   %%% %%%         %   %%%%%%%%%%%%%%%%%   %%% %%%%%   %%%%%%%   % %     %
% %%%%% %%%%% %%%%%%%%%%%%% % %%% %%% %%%%%%% % % %%%%%%%%%%%%%%%%%%% %%%%%%%%%%% %%%%%%%%% % %%%%% %
% %%%%%           %%%%%%%   %   %     % %%%     % %%%     %   %%%       %%%   %%% %%%%%%%%%   %%%%% %
% %%%%% %%%%% %%% %%%%%%% %%% %%% %%% % %%% %%%%% %%% % %%% % %%%%%%% %%%%% %%%%%%%%%%%%%%% %%%%%%%%%
% %%%%% %%%%% %%%   %%% % %%%     %%%   %%% %%%%% %%% % %%% % %%%%%%% %%%   %%%%%%%   %%%%% %%%%%%%%%
%%%%%%%%%%%%% %%%%% %%% % %%% %%%%%%%%% %%%%%%%%%%%%%%% %%% % %%%%%%% %%%%% %%%%%%% % %%%%% %%%%%%%%%
%%%%%%%%%   % % %%%   %   %%% %%%   % % %%%%%   %%%     %%% %         %       %%%%% % %%%       %%% %
%%%%%%%%% % % % %%%%% %%% %%%%%%% % % % %%%%%%% %%% %%% %%% %%%%%%%%% %%% %%% %%%%% %%%%%%% %%% %%% %
%     %%% % % %     %   %   %%%   % %   %%%   %     %%% %%%       %%% %%%   %   %   %%% %%% %%% %%% %
%%%%% %%% %%% %%%%% %%% %%%%%%% %%% %%% %%% % %%% %%%%%%%%%%%%%%% %%%%%%%%% %%% %%% %%% %%%%%%%%%%% %
%%%%%     %%%     % %%%         %   %%%     % %%% %%% %%% %%%%%%% %%%%% %%%   %     %%%   %%% %%%   %
%%%%%%% % %%%%%%% % %%%%%%% %%% % %%%%%%%%%%% %%% %%% %%% %%%%%%% %%%%% %%% % %%%%%%%%% % %%% %%% %%%
%%%%%%% % %%%%% %     % %%% %%% % %%% %%%%%%%             %%%%%%%   %   %%% % %%%%%%%%% %     %%% %%%
%%%%%%% % %%%%% %%%%% % %%%%%%% % %%% %%%%%%%%% %%% %%% %%%%%%%%%%% %%% %%%%% %%%%%%%%%%% %%%%%%% %%%
%%%%%%% % %%%%%   %%%     %%%   %   %     %%%%% %%% %%% %%%         %     %%%         %%%   %%%%%   %
%%%%%%% % %%%%% %%%%%%% %%%%% %%% %%% %%% %%%%%%%%% %%%%%%% %%%%%%% % %%% %%%%%%% % %%%%%%% %%%%%%% %
% %     % %%%         % %%%%% %%% %   %%%       % %   %%%     %%%%%   %%%       % %     %%%         %
% % % % %%%%%%%%% %%%%% %%%%%%%%% % %%%%% %%%%% % %%% %%%%%%%%%%%%%%%%%%%%%%%%% %%%%% %%%%% %%%%% %%%
%   % % %%% %%%   %%%%% %%%%%%% %     %%%   %   % %     %%%%%%%%%   %%% %%%%%     %%% %%%   %%%   %%%
% %%% % %%% %%% % %%%%% %%%%%%% % %%% %%% %%% %%% % %%%%%%%%%%%%% %%%%% %%%%%%%%% %%% %%% % %%% %%%%%
% %%% %         % %%%   %   %%%   %%% %%% %%% %%%     %%%   %%%%% %%%   %%% %%%   %   %%% %   % %   %
% %%% %%% %%%%%%%%%%% %%% %%%%%%%%%%%%%%%%%%% %%%%%%% %%% %%%%%%% %%%%% %%% %%%%% %%% %%% %%% % %%% %
% %   %%% %%%%%       %   %%%%%%%%%%%%%%%%%%%   %%%%%     %%%%%%%             %%% %     % %   %     %
% % %%%%% %%%%% %%% %%% %%%%%%%%%%%%%%%%%%%%% % %%%%% %%%%%%%%%%% %%% %%%%% %%%%% % %%% %%% %%%%%%% %
% % %%%%% %     %%% %%%     %%%%%%%   %%% %%% %   %   %%%%%         % %%%   %%%%%   %%%     %     % %
%%% %%%%% % %%%%%%%%%%%%% % %%%%%%% %%%%% %%%%%%% % %%%%%%% %%%%%%% %%%%%%%%%%%%% %%%%%%%%%%% %%%%% %
%%%   %%% %   %%% %%% %%% %   %%%%%   %%%   %%%%% % %%%     %%%%%%% %%% %%%%%     %%%%% %%%     %   %
%%% %%%%%%%%% %%% %%% %%% % %%%%%%%%% %%% %%%%%%% %%%%%%%%% %%%%%%% %%% %%%%%%%%% %%%%% %%%%%%% % %%%
%         %         % %%% % %%%   %%%     %%% %%% %%%%%%%%%   %%%       % %%%%%%%   %%%   %%%%%   % %
% %%%%%%% % %%%%%%% % %%% %%%%% %%%%% %%% %%% %%% %%%%%%%%%%% %%% %%%%% % %%%%%%%%%%%%%%% %%%%% %%% %
%     %   % %%%   %     %       %%%   %%% %   %     %     %   %%%   %%%         %%%%%%%   %     %   %
% %%%%% %%% %%% % %%%%% %%% %%% %%% %%%%%%% % % %%% % %%% %%%%%%%%% %%%%%%%%%%% %%%%%%% % % %%%%%%% %
% %%%%%     %%% %   %%% %%%   % %   %%% %%% %   %%% % %%%     %       %%%%%%%   %%%     % %   %%%%% %
% %%%%%%%%%%%%% % %%%%% %%%%% % % % %%% %%% %%%%%%% % %%%%%%% % %%% %%%%%%%%%%%%%%% %%%%% %%% %%%%% %
% %       %%% % %     %       %   % %     % %%%   %     %%%   %   % %     %           %     %       %
% % %%% %%%%% % %%%%% %%% %%%%%%%%% % % %%% %%%%% %%% %%%%% %%%%% %%% %%% % %%%%% %%% %%% %%% %%%%% %
%   %%% %%%   % % %%%     %%%     % % % %%%   %%% %%% %%%%%       %   %%%     %%% %   %%% %   %%%%% %
%%%%%%% %%%%% % % %%%%%%%%%%% %%% % %%% %%% %%%%% %%% %%%%%%%%%%%%% %%%%%%%%% %%%%% %%%%%%% %%%%%%%%%
% %%% %   %%%   %     %%%%% %   %   %%% %   %%%%%       %%%%%%%%%%% %%%   %%% %%%   %%%     %%%%%%%%%
% %%% % %%%%%%% % %%% %%%%% %%% %%%%%%% % %%%%%%%%%%%%%%%%%%%%%%%%% %%%%% %%%%%%% %%%%% %%%%%%%%%%%%%
% %     %%% %%% % %%% % %%%     %%%%%   %         %%%       %               %%%         %%%%%%%%%%%%%
% % %%%%%%% %%% % %%% % %%%%%%% %%%%% % %%%%%%%%% %%% %%% %%% %%%%%%% %%% %%%%%%%%%%%%% %%%%%%%%%%%%%
%   % %%%     % % %%%     %%%%% %     %   %%%%%   %%% %%%     %%%%%%% %%% %%%%%%%%%%%%% %%%%%%%%%%%%%
%%% % %%% %%% % % %%%%%%%%%%%%% % % %%%%% %%%%% %%%%% %%%%%%% %%%%%%% %%%%%%%%%%%%%%%%% %%%%%%%%%%%%%
%%%   %%% %%%     %%%%%%%%%%%%%   % %%%       %         %%%%%     %%%   %%%%%%%%%%%       %%%%%%%%%%%
%%%%%%%%%%%%%%%%%%%%%%%%%%%%%%%%%%%%%%%%%%%%%%%%%%%%%%%%%%%%%%%%%%%%%%%%%%%%%%%%%%%%%%%%%%%%%%%%%%%%%
