%%%%%%%%%%%%%%%%%%%%%%%%%%%%%%%%%%%%%%%%%%%%%%%%%%%%%%%%%%%%%%%%%%%%%%%%%%%%%%%%%%%%%%%%%%%%%%%%%%%%%
%%%%%%%%%%%%%%%%%   %%%     %%%%%         %   %%%%%       %%%               %%%%%%%%%%%%%%%%%%%%%%%%%
%%%%%%%%%%%%%%%%% % %%%%%%% %%%%% %%% %%% % %%%%%%%%%%% %%%%% %%%%% %%%%%%% %%%%%%%%%%%%%%%%%%%%%%%%%
%%%%%%%%%%%%%%%   % %           %   % %%%   %%%         %%% %   %%%   %%%   %%%%%%%%%%%%%%%%%%%%%%%%%
%%%%%%%%%%%%%%%%% % % % %%%%%%% %%% %%%%% %%%%%%% % %%%%%%% % %%%%%%%%%%% %%%%%%%%%%%%%%%%%%%%%%%%%%%
%%%%%%%%%%%%%%%%% %   % % %%% % %   %%%%% %%% %%% %     %%%   %%% %%%     %%%%%%%%%%%%%%%%%%%%%%%%%%%
%%%%%%%%%%%%%%%%%%%%%%% % %%% % % %%%%%%%%%%% %%% %%%%% %%% %%%%% %%% %%% %%%%%%%%%%%%%%%%%%%%%%%%%%%
%%%%%%%%%%%%%%%%%%%%%%% %     % % %%%%%%%%%   %%% %%%   %   %%%%%     %%% %   %%%%%%%%%%%%%%%%%%%%%%%
%%%%%%%%%%%%%%%%%%%%%%% %%%%% % % %%%%%%%%% %%%%%%%%% %%% %%%%%%%%% %%%%%%% % %%%%%%%%%%%%%%%%%%%%%%%
%%%%%%%%%%%%%%%%%   %%% %%%%%     %%%%%%%   %%% %%%       %%%   %%%     %%% %   %%%%%%%%%%%%%%%%%%%%%
%%%%%%%%%%%%%%%%% %%%%% %%%%%%%%% %%%%%%% % %%% %%% %%% %%%%%%% %%%%% %%%%% %%% %%%%%%%%%%%%%%%%%%%%%
%%%%%%%%%%%%%%%   %%%       %%%   %%% %%% % %       %%%   %   %   %%%       %%% %%%%%%%%%%%%%%%%%%%%%
%%%%%%%%%%%%%%%%% %%% %%% %%%%% %%%%% %%% % % %%%%%%%%%%% % % %%% %%%%%%%%%%%%% %%%%%%%%%%%%%%%%%%%%%
%%%%%%%%%%%%%%%%%     %   %%%   %%%   %%% % %   % %%%%%     % %%%   %%%%%     %   %%%%%%%%%%%%%%%%%%%
%%%%%%%%%%%%%%%%% % % %%% %%%%%%%%% %%%%%%% %%% % %%%%% %%%%% %%% % %%%%% % %%%%% %%%%%%%%%%%%%%%%%%%
%%%%%%%%%%%%%%%%% % % %%% %%%               %%%   % %%% %%%%%     %       % %       %%%%%%%%%%%%%%%%%
%%%%%%%%%%%%%%%%%%% % %%%%%%% %%%%%%% %%% %%%%%%% % %%%%%%%%%%% %%%%% %%%%%%% %%%%%%%%%%%%%%%%%%%%%%%
%%%%%%%%%%%   %%%%% % %%%   % %%%%%%% %%% %%% %%%     %%%%% %%% %%%   %%%%%%%   %%%%%%%%%%%%%%%%%%%%%
%%%%%%%%%%% %%%%%%% %%%%% % % %%%%%%%%%%% %%% %%%%%%% %%%%% %%% %%%%% %%%%%%%%% %%%%%%%%%%%%%%%%%%%%%
%%%%%%%%%%%         %%%   %   %%%%%%%%%   %   %%%   % % %%%       %%% %       %   %%%%%%%   %%%%%%%%%
%%%%%%%%%%% %%%%%%% %%% %%%%%%%%%%%%%%% % %%% %%% % % % %%%%% %%% %%% % %%%%% %%% %%%%%%% % %%%%%%%%%
%%%%%%%%% %     % %   % %%%%%%% %%%%%%% %     %%% %     % %%% %%% %%% %     % %   %%%%%   %   %%%%%%%
%%%%%%%%% % %%% % %%% % %%%%%%% %%%%%%% % %%%%%%%%%%%%% % %%%%%%%%%%% %%%%% %%% %%%%%%% % %%% %%%%%%%
%%%%%%%     %%%     %     %%%           % %%%%% %%%%%     %%%%%%%%%         %%%         % %%% %%%%%%%
%%%%%%%%% %%%%%%%%%%%%%%%%%%% %%% % %%%%% %%%%% %%%%% %%% %%%%%%%%% %%%%%%% %%%%%%% %%%%% %%%%%%%%%%%
% %%% %%% %%%   %%%   %     % %%% % %%%%%   %   %%%%% %%% %%%%%%%   %%%%%%%   %%%%% %%%%%       %%%%%
% %%% %%%%%%% % %%% % % %%% %%%%% %%%%%%%%%%% % %%%%% %%%%%%%%%%% %%%%%%%%% %%%%%%% %%%%%%%%% % %%%%%
%    !    %%% %     %   %%%   %%% %%%         %     % %%%%% %%%   %%%   %%% %%%%%     %%% %%% % %%% %
% % %%%%% %%% % %%%%%%%%%%%%% %%% %%% %%%%%%%%% %%%%% %%%%% %%%%%%%%% % %%% %%%%%%%%% %%% %%% % %%% %
% %   %       % %%%%%%% %%% % %   %%% %%%%%%%%% %%%%% %       %%%%%%% %         %%%%%       % %     %
% %%% %%%%%%% %%%%%%%%% %%% % %%% %%% %%%%%%%%% %%%%% % %%%%% %%%%%%%%%%%%%%%%%%%%%%%%% %%%%% %%% %%%
% %   %%%   % %%%   %%%             %         %       % %%%     %%%%%%%%%   %       %%% %%%   %%% %%%
% % %%%%% %%% %%%%% %%%%% %%%%%%%%% %%%%% %%%%%%%%%%% % %%%%% %%%%%%%%%%% % % %%%%% %%% %%% %%%%%%%%%
% % %%%%%     %       %%% %%%%%%%%% %     %%%%%%% %%%     %%% %%% %%% %   %   %%%%%   %   %     %%%%%
%%% %%%%% %%%%%%% %%% %%%%%%%%%%%%%%% %%%%%%%%%%% %%%%%%%%%%%%%%% %%% % % %%%%%%%%%%% %%%%%%% % %%%%%
%%% %       % %%% %%%   %%%%%%%   %%%   %%% %%%   %           %   %     % %%%         %%%     %   %%%
%%% %%%%%%% % %%% %%%%%%%%%%%%% %%%%%%% %%% %%% %%% %%% %%%%% % % %%% %%% %%% %%%%% %%%%% %%%%%%% %%%
%%%       %   %     %%%%%%%%%   %%% %%%         %%% %%% %%%     % %%% %   %     %%% %%%   %%%       %
%%% %%%%% %%% % % %%%%%%%%%%% %%%%% %%%%% %%% %%%%% %%% %%% %%%%% %%%%% %%%%%%% %%%%%%% %%%%%%% %%%%%
%%%   % % %%%   % %%% %%% %%%         %   %%% %%%   %   %%%   %%%       %%%%%   % %%%%%     %%% %%%%%
%%%%% % % %%%%%%%%%%% %%% %%% %%% % %%% %%%%%%%%%%% %%% %%%%% %%%%%%%%%%%%%%% %%% %%%%% %%% %%%%%%%%%
%   %   % %           %%%     %%% % %%% %%%%%%%     %%% %%%%% %%%%%   %%% %%%     %%%%% %%%     %%%%%
%%% %%% % % %%%%% %%%%%%%%%%% %%% % %%% %%%%%%% % %%%%% %%%%% %%%%%%% %%% %%%%%%% %%%%% %%%%%%% %%%%%
%   %   %   %%%%%   %%%%%%%%%   % %   %     %%% % %%%%% %%%       %%%     %%%%% % %%% %   %         %
% %%% %%% %%%%%%%%% %%%%%%%%%%%%% %%% %%%%% %%%%% %%%%%%%%%%%%%%%%%%%%% % %%%%% % %%% % %%% %%% %%%%%
%     %%%   %%% %%% %%%           %   %   %   %%%   %%%%%%%%%%%%%%% %%% %   %     %     %   %%% %%%%%
%%%%% %%%%%%%%% %%% %%% %%%%% %%%%% %%% % % %%%%% %%%%%%%%%%%%%%%%% %%% %%%%% %%%%%%% %%% % %%%%%%%%%
%%%%% %%%%%         %%% %%%   %%%%% %   %   %%%   %       %%% %%%   %%%       % %%%%% %   % %%%%%   %
%%%%%%%%%%% %%% %%% %%%%%%% %%%%%%%%% %%%%%%%%% %%% % %%%%%%% %%% % %%%%% %%%%% %%%%%%% %%%%%%%%% % %
%%% %%%%%   %   %%%       %       %%%   %%%%%%%   % %             %   %%%   %%% %%% %%% %%%%%%%%% % %
%%% %%%%% % %%% %%%%% %%% %%% %%%%%%%%% %%%%%%%%% % %%%%%%%%% %%% %%% %%% %%%%% %%% %%% %%%%%%%%%%% %
%     %   % %%%   %%% %%%     %%%%%   % % %%%   %         %%% %   %%% %%% %%%   %%%                 %
% %%% % %%%%%%% %%%%%%%%%%% %%%%%%% % % % %%% % %%%%%%% %%%%%%% %%%%%%%%% %%% % %%% %%%%% %%%%% %%%%%
% %%% %   %%%   %%% %%%%%   %%% %%% %         % %%%%%%% %%% %%% %%%S%%%       %     % %%% %%%   %%%%%
% %%% %%% %%%%% %%% %%%%%%%%%%% %%% %%%%%%%%%%% %%%%%%%%%%% %%% %%% %%% %%%%%%%%%%%%% %%% %%%%%%%%%%%
%   %       %%% %%%     %%%       %   %%%%%%%%%     %%%%%%%     %   %%% %         %%%   %   %%%%%%% %
%%% %%% %%%%%%%%%%% %%% %%% %%%%% %%% %%%%%%%%%%% %%%%%%%%% %%% % %%%%%%% %%%%%%% %%%%% %%% %%%%%%% %
%   % % %%%%% %%%   %%%     %%%%%   % %%%%% %%%%% %%%       %%% %         %%%%%   %%%%%       %%%%% %
% %%% % %%%%% %%% %%%%%%%%%%%%%%%%% % %%%%% %%%%%%%%%%%%%%% %%% %%%%%%%%%%%%%%% %%%%%%% %%%%%%%%%%% %
%   %   %         %%% %%%     %%%   % %     %%%%%%% %%%%%%% %%%             %%%       % %%%%%%%%%   %
%%% %%%%% %%%%%%%%%%% %%% %%% %%% %%% % % %%%%%%%%% %%%%%%%%%%% %%% %%% % %%%%%%%%%%% %%%%%%%%%%% %%%
%   %%%       %%%%%%%   % %   %%% %%%   % %%%%%       %%%   %%% %%% %%% % %%% %%%                 %%%
% %%%%% %%%%%%%%%%%%% % % %%%%%%% %%%%%%% %%%%% %%% %%%%% % %%%%%%% %%% %%%%% %%%%%%%%%%%%%%%%% %%%%%
%     % %%%%%%%%%     % % %     %         %%%   %%% %%%   %     %%% %%% %%%%%   %%%%%%%%% %%%   %%%%%
%%%%% % %%%%%%%%%%% %%% % % % %%%%%%%%%%% %%% %%%%% %%% %%%%%%% %%%%%%% %%%%% % %%%%%%%%% %%% %%%%%%%
%%%   %             %%% %   %       %%%%% %%% %%%     %   %%%             %%% % %%%%%%%%%   %   %%%%%
%%% %%%%%%%%%%%%%%%%%%% %%% %%% %%% %%%%%%%%% %%%%%%% %%% %%%%%%% %%%%%%% %%% %%%%%%%%%%% %%%%% %%%%%
%%% %%%     %%%%%       %%%   % %   %%%%%%%       %%%   %       % %%%%%%% %   %%%%%%%%%%% %     %%%%%
%%% %%% % %%%%%%%%%%%%% %%%%%%% % %%%%%%%%%%%%%%% %%%%%%%%%%%%% %%%%%%%%% % % %%%%%%%%%%% % %%%%%%%%%
%%% %   %     %%%%%%%%%   %   % % %%%%%%%%%%%     %     %%% %%%       %     % %%%%%%%%% %   %   %%%%%
%%% % %%%%% % %%%%%%%%%%% % % % %%%%%%%%%%%%% %%%%% %%% %%% %%%%%%%%% % %%% %%%%%%%%%%% % %%% % %%%%%
%   % %%%   % %%%%%%%%%     %   %%%%% %%%%%   %%%%% %%%     %     %   % %%% %%% %%%%%     %   % %%%%%
% % % %%% %%% %%%%%%%%%%%%% %%% %%%%% %%%%% % %%%%% %%% %%%%% % %%% %%% %%%%%%% %%%%%%%%% % %%% %%%%%
% %   %%% %   %%%%%%%%%%%%% %%% %%%   %%%%% %       %%%       %   % %     %%%     %%%%%%%   %   %   %
%%%%%%%%% %%% %%%%%%%%%%%%%%%%% %%%%% %%%%% %%% %%%%%%%%%%%%%%%%% % %%% %%%%%%%%% %%%%%%%%%%% %%%%% %
%         %%% %%% %%%%%%% %%%%%   %%%   %   %%%   %%% %%% %%%%%%% %   % %%% %%%   %%% %%%         % %
% %%%%%%%%%%% %%% %%%%%%% %%%%%%% %%%%% % %%%%%%% %%% %%% %%%%%%% %%% %%%%% %%% %%%%% %%% %%%%%%% % %
% %%%%%%%     %     %%%%%     %%%   %%%   %%%%%%%       %     %%% %%%       %           % %%%%%     %
% %%%%%%%%%%% % %%% %%%%% %%% %%% %%%%% %%%%%%%%% %%%%% %%%%% %%% %%%%%%%%% % %%%%%%%%% % %%%%%%%%%%%
%           %   %   %       %   % %%%%% %%%%%%%   %%%%%     %   %   %   %%%   %%%   %%%   % %%%%%%%%%
%%% %%%%%%% %%% %%%%% %%%%%%%%% % %%%%% %%%%%%% %%%%%%%%%%% % %%% % % % %%%%%%%%%%% %%%%% % %%%%%%%%%
%%%   %%%   %%% %   % %%% %%%%%   %%%%% %%%%%   %%% %%%       %%% %   % %%% %%%   % %%%%%     %%%   %
%%%%%%%%% %%%%% % % % %%% %%%%%%%%%%%%%%%%%%% %%%%% %%% %%%%%%%%% %%%%% %%% %%% % % %%%%% %%%%%%% %%%
%%%%%%% %   %   % %   %     % %%%%%   %%%%%   %%%%%   % % %%%%% % %     %   %%% %     %%% %%%%%   %%%
%%%%%%% % % %%%%% %%%%% %%% % %%%%% %%%%%%%%%%%%%%% %%% % %%%%% % % %%%%% % %%% % %%% %%%%%%%%%%% %%%
%%%%%     %   %%% %%%   %%%     %         %%%%%%%           %%% % %       %     % %%% %%%%%   %%%   %
%%%%% %%% %%% %%% %%%%% %%%%%%% % %%% %%% %%%%%%%%%%%%%%% %%%%% % %%% %%% %%%%% %%%%% %%%%%%% %%%%% %
%%%   %%% %%% %%%         %%%   %   % %%%   %%%%%%%%%%%%% %%% %   %%% %%%   %   %%%             %%% %
%%%%%%%%% %%% %%% %%%%% %%%%% %%%%%%% %%%%% %%%%%%%%%%%%%%%%% % %%%%% %%%%%%% %%%%%%% %%%%%%%%% %%% %
% %%%%%%%   %     %%%   %%%%%         %   % %     %%%%% %%%%%   %%%     %   %     %%% %%% %%%       %
% %%%%%%%%%%%%%%% %%%%%%%%%%%%%%%%%%%%%%% % %%% % %%%%% %%%%% %%%%%%%%% % % % %%% %%%%%%% %%%%% %%% %
% %     %%%%%%%%% %%%%%%%%% %%%%%   %%%%%   %%% %   %%% %   %     %%%   % % %   %     % %   %%% %%% %
% % %%% %%%%%%%%%%%%%%%%%%% %%%%%%% %%%%% %%%%%%% %%%%% % % %%%%% %%%%%%% % %%%%%%% % % % % %%% %%% %
%   %%%   %%%%%%%%%%%%%%%       %%% %%%%% %   %%%       % %         %%%%% %       % % %   %   % %%% %
%%%%%%% %%%%%%%%%%%%%%%%% %%%%% %%% %%%%% %%% %%%%% %%% % %%% %%%%%%%%%%% % %%%%% %%% % %%%%% % %%%%%
%%%%%   %%% %%%%%%%%%%%     %%% %%% %             %   %   %%%     %%%%%%% % %%%%%     %   %%% %   %%%
%%%%% %%%%% %%%%%%%%%%% %%%%%%% %%% % %%%%%%%%%%% %%%%%%% %%%%%%%%%%%%%%% %%%%%%% %%% %%% %%% % %%%%%
% %   %       %%% %%%   %%%%%%%   %     %%%%%%%     %%%%% %     %%% %%%   %%%%%   %%% %%%   %   %%%%%
% % % % %%%%% %%% %%% %%%%%%%%% % % %%% %%%%%%%%%%% %%%%%%% %%% %%% %%% %%%%%%% %%%%%%%%% %%%%%%%%%%%
%   %       %         %%%%%%%%% %   %%%     %%%%%%%         %%%         %%%%%%%   %%%%%%% %%%%%%%%%%%
%%%%%%%%%%%%%%%%%%%%%%%%%%%%%%%%%%%%%%%%%%%%%%%%%%%%%%%%%%%%%%%%%%%%%%%%%%%%%%%%%%%%%%%%%%%%%%%%%%%%%
