%%%%%%%%%%%%%%%%%%%%%%%%%%%%%%%%%%%%%%%%%%%%%%%%%%%%%%%%%%%%%%%%%%%%%%%%%%%%%%%%%%%%%%%%%%%%%%%%%%%%%
%%% %       %%%   %%%%%     %%% %%% %     %%% %     %%%%%%%%%%%     %%%%%%%         %%%       %%% %%%
%%% % %%%%% %%%%% %%%%% %%%%%%% %%% % % %%%%% % %%% %%%%%%%%%%%%% %%%%%%%%% %%% %%%%%%% %%%%% %%% %%%
%       %%%   %%% %%%       %%%     % %       % %%%       %     %             % %%%%%%%     %     %%%
%%% %%% %%%%% %%% %%% %%%%% %%% %%% % %%%%% %%% %%%%% %%% % %%% %%%%%%%%%%%%% %%%%%%%%%%%%% % % %%%%%
%%% %%%     %       % %%% %     %%% % %   % %%%   %%% %%%   %%%   %   %%%%%%%       %%%%%   % % %%%%%
%%% %%%%%%% %%%%% %%% %%% % % %%%%%%% % % % %%%%% %%% %%%%% %%%%% % % %%%%%%%%% %%% %%%%%%%%% % %%%%%
%     %%%%%   % %   % %   % % %%%     % % %   %%% %%% %%%   % %%%   %           %%%           % % %%%
%%%%%%%%%%%%% % %%% % % %%% %%%%% %%%%% %%% %%%%% %%% %%%%% % %%%%%%%%% %%%%%%% %%%%% %%%%%%%%% % %%%
%     %         %%%     %%% %%% %       %%%     % %%% % %%%     %%%%%   %%%     % %%% %%%%% %   %   %
% %%% %%%%%%% %%%%% %%%%%%% %%% %%%%%%% %%%%%%% % %%% % %%%%% %%%%%%%%%%%%% %%%%% %%%%%%%%% % %%% %%%
%   %   %%%%% %%%%% %%%%%   %%%   %%%%% % %%%%%   %   % %%%   %%%   %%%%%%%       %%%%%%%%%       %%%
%%% %%% %%%%%%%%%%%%%%%%% % %%% % %%%%% % %%%%%%%%% %%% %%% %%%%% % %%%%%%%%%%%%% %%%%%%%%%%% %%%%%%%
%%% %   %%%   %       %%% %     %   %     %%%       %       %%%   %   % %%%%%%%%% %     %%%%% %%%%%%%
%%% %%% %%% % % %%%%% %%% %%% %%%%% % %%%%%%% %%%%%%% %%% %%%%% %%%%% % %%%%%%%%% % %%%%%%%%%%%%%%%%%
%%%   %     %   %     %%%   %   %   % % %%%   %%%%%   %%% %%%     %%%       %%% %   %%%%%%% %%%%%%%%%
%%% % %%%%%%%%%%% %%%%%%%%%%% % %%%%% % %%%%% %%%%%%%%%%%%%%%%% % %%%%%%% %%%%% %%% %%%%%%% %%%%%%%%%
%   % %%%   %%%   % %   %%%%% % %         %%%     %%%%% %%%%%%% % %%%%%   %%%     % %%%   %   %%%%% %
%%%%% %%% %%%%% %%% % % %%%%%%% % %%%%%%% %%%%% %%%%%%% %%%%%%%%% %%%%%%%%%%%%% %%% %%% % %%% %%%%% %
%     %%% %%% % %     % %%%%%%%   %%% %%%   %   %%%%%   %%%%%     %%% %%%%% %%%   % %%% %   %   %   %
% %%%%%%% %%% % %%%%%%% %%%%%%% %%%%% %%%%%%% %%%%%%%%% %%%%% %%% %%% %%%%% %%%%% % %%% %%% % % %%% %
% %%%   %   %   %       %%%%%%%   %     %%%   %%%   %%%       %   %%%   %%%   %%%   %   %%% % %     %
% %%%%% % % % %%% %%%%% %%%%%%%%% %%%%% %%% % %%% %%%%%%% %%%%%%%%%%% %%%%% %%%%% %%% %%%%% % %%% %%%
%     % % % %     %         %%%%%       %%% %   % %%%     %%%%%%%%%   %%%   %%% %     %%%   % %   %%%
%%%%% % % % %%% %%%%%%%%%%% %%%%%%% %%%%%%% %%% % %%% %%%%%%%%%%%%% %%%%% %%%%% %%%%%%%%% %%% %%%%%%%
%%%%% % % %     %%%%%%% %%%   %%%   %%%     %     %%% %%%%%     %%%         %%%         % %   %%%%% %
%%%%% % % %%%%%%%%%%%%% %%% %%%%%%%%%%% %%%%%%%%%%%%% %%%%% %%% %%% %%%%%%% %%% %%%%%%%%% % %%%%%%% %
%     %     %%%%%%% %%%     %%%%%%%%%       %       %       %%% %   %     %       %%%%%     %%%     %
%%%%% %%%%%%%%%%%%% %%%%%%% %%%%%%%%% %%%%% % %%%%% % % %%% %%%%% %%% %%%%% %%%%% %%%%% %%% %%% %%%%%
%%%%% %         %%%   %%%%% %%%%%%%%%     %   %     % % %%% % %%% %   %%%%%   %%%     % %%% %%% %%%%%
%%%%% % %%%%%%% %%%%% %%%%% %%%%%%%%%%%%%%% %%% %%%%%%% %%% % %%% %%% %%%%%%% %%%%%%% % %%%%%%% %%%%%
%%%           %   %%% %%%%%     %%%%%   %%% %%% %   %%% %%%     % %%%     %%%     %%%     %%%   %%%%%
%%% %%%%%%% %%%%% %%% %%%%%%%%% %%%%% % %%%%%%% % % %%% %%%%% %%% %%% %%% %%%%%%% %%%%%%% %%% %%%%%%%
%       %%% %%%%%     %%%%%%%%%     % %   %%%   % %       %%% %   %   %%% %%%       %%%%%     %%%%%%%
% %%%%% %%%%%%%%%%%%% %%%%%%%%%%%%% % %%% %%% %%% % %%%%% %%%%% %%%%%%%%% %%% %%% %%%%%%% %%% %%%%%%%
% %%%%% % %%%     %%%   %%%%% %%%     %       %%% %   %     %%% %%%   %   %%% %%% %%%%%%% %%% %%%%%%%
%%%%%%% % %%% %%% %%%%% %%%%% %%% %%%%% %%%%%%%%% %%% %%%%% %%% %%% % % %%%%% %%%%%%%%%%%%%%% %%%%%%%
%%%       %%%   %   %%% %   %     %%%     %%%       % %%%     %     %   %%%%%   %%%%%%%%%%%%% %%%%%%%
%%%%%%%%% %%% % %%% %%% %%% % %%%%%%%%%%%%%%%%% %%%%% %%% %%%%% %%% %%%%%%%%%%%%%%%%%%%%%%%%% %%%%%%%
% %%%%%%% %%% % %%%     %%% %!      %%%%%%%%%%% %%%%%   % %%%   %%% %%%%% %%%%%%% %%%%%%%%%%% %%%%%%%
% %%%%%%%%%%% % %%%%%%%%%%% %%%%% %%%%%%%%%%%%%%%%%%%%% %%%%% %%%%%%%%%%% %%%%%%% %%%%%%%%%%%%%%%%%%%
%   %%% %%%%% % %%%%%%%   %   %   %%%%%%% %%%%%%%%%%%%%   %%% %%%%%%% %S%               %   %%%%%%%%%
%%% %%% %%%%%%% %%%%%%%%% % % % %%%%%%%%% %%%%%%%%%%%%%%% %%% %%%%%%% % %%%%% % %%%%%%% % %%%%%%%%%%%
%%%     %   %%%       %%%   % % %   %%%   %%%%% %%%%%%%%%   %   %%%%% %     % %     %%% % %%% %%%%% %
%%%%% % % % %%%%%%%%% %%%%%%% % % %%%%% % %%%%% %%%%%%%%% % %%% %%%%% %%%%% %%%%%%% %%% % %%% %%%%% %
% %%% %   %           %%%%%%%     %%%   %   %   % %%%   % %     %%%   %             % %   %   %%%   %
% %%%%% %%%%% %%%%%%%%%%%%%%% %%% %%% % %%% % % % %%% %%% %%% %%%%%%% % %%%%%%%%%%%%% %%% %%% %%% % %
%   %%%   %%% %       %%%     %%% %%% %   %   %   %%% %%% %%% %%% %%%   %%%   %%%       %   %     % %
%%% %%%%%%%%% % %%%%% %%% %%%%%%%%%%% %%% %%%%%%% %%% %%% %%% %%% %%%%%%%%%%% %%% %%% %%%%% % %%%%% %
%%% %%%%%%%   %   %%%       %%%%%%%   %%% %%%%%%% %%%     %%% %%%   %%%%%%%%%     %%% %%% %   %%%%% %
%%% %%%%%%%%% %%%%%%%%%%%%%%%%%%%%%%% %%% %%%%%%% %%%%%%% %%%%%%% % %%%%%%%%% %%% %%% %%% % %%%%%%%%%
%             %%%%% %%%%%%%%%%%%%%%%% %   %%% %%% %%%%%%% %%%%%   %   %%%%%   %   % % %     %%%   %%%
%%% %%%%% %%%%%%%%% %%%%%%%%%%%%%%%%%%% %%%%% %%%%%%%%%%%%%%%%% % %%% %%%%%%%%% %%% % % %%%%%%% % %%%
%%% %   %                   %%%%% %%%   %%%   %       %     %   % %%%     %%%   %%% % %         %   %
%%% % % %%%%% %%% %%%%% %%% %%%%% %%% %%%%% % % %%%%% % %%% % %%% %%%%%%%%%%% %%%%% % %%%%%%%%% %%%%%
%     % %%%%%   % %%%%% %%% %     %         %   %%%%% %   %   %%% %%%%%%%     %%%     %%%%%%%   %%%%%
% %%% %%%%%%% %%% %%%%%%%%%%% % %%% %%%%%%%%%%%%%%%%% % %%% %%%%% %%%%%%% % %%%%% %%% %%%%%%% %%%%%%%
% %%% %%% %%% %%% %   %%%%%%% %     %%% %%% %%%%%%% %   %%% %%%   %%% %%% % %     %%%   %%%   %%%%%%%
%%%%% %%% %%%%%%% % % %%%%%%% %%%%%%%%% %%% %%%%%%% % %%%%% %%%%% %%% %%% % %%% %%%%%%% %%% %%%%%%%%%
%%%%%     %%%%%%%   %               %           %%%   %%%     %       %%% %   % %%% %%% %   %%%%%%%%%
%%%%%%%%%%%%%%%%% %%%%% %%%%%%%%%%% %%%%% %%%%% %%%%% %%%%%%%%% %%% %%%%% %%% %%%%% %%%%% %%%%%%%%%%%
%   %%%%%%%%%   %   %%%   %%%%%     %%%%%     %   %%%   %%%%%   %   %%%%% % %           % %%%%%%%%%%%
%%% %%%%%%%%%%% %%% %%%%%%%%%%% %%%%%%%%%%%%% %%%%%%% %%%%%%% %%%%% %%%%% % %%%%%%%%% % % %%%%%%%%%%%
%%%   %%%%%%%%% %     %%%%%%% % %%%%%%%       %%%%%   %%%   % %%%%%     %   %%%%% %%% %   %%%%%%%%%%%
%%%%% %%%%%%%%% % %%%%%%%%%%% % %%%%%%% %%%%% %%%%%%% %%% %%% %%%%% %%% %%% %%%%% %%% %%% %%%%%%%%%%%
%%%     %%%%%       %%%%%%% %   %%%%%   %     %%% %%%     %%% %%%   %%% %   %%%%% %%% %%%   %%%%%%%%%
%%% % %%%%%%%%%%%%%%%%%%%%% % %%%%%%% % % %%%%%%% %%%%% %%%%% %%%%%%%%%%% %%%%%%% %%%%%%%%%%%%%%%%%%%
%%% % %%%   %%%%%%%%%   %%% % %   %   % % %%%%%%% %%%   %%% %     %       %%%       %%% %%%%%   %%% %
%%% %%%%%%% %%%%%%%%%%% %%% % %%% % %%% %%%%%%%%% %%%%% %%% %%%%% % %%%%%%%%%%% %%% %%% %%%%% %%%%% %
%   %%% %%%         %%% %%%   %%% % %%%             %%%         %   %%%   %%%%% %%%       %   %%%   %
% %%%%% %%%%%%% %%%%%%% %%% %%%%% % %%%%% %%%%%%%%% %%% %%%%%%% %%%%%%%%% %%%%%%%%% %%%%% % % %%%%% %
% %%%   %%%     %%%%%   %   %         %%%   %       %%% %%%%%     %%%%%%%   %%%%%   %   %   %     % %
% %%%%% %%% %%%%%%%%% %%% %%%%%%% %%% %%%%%%% %%%%% %%%%%%%%%%% %%%%%%%%% %%%%%%%%% %%% %%%%%%%%% % %
%   %%%           %         %%%%% %%% %%%%%%%   %     %%%%%%%%% %%%       %%%       %%%             %
% % %%% %%% %%% % % %%%%%%%%%%%%%%%%% %%%%%%% % %%%%% %%%%%%%%%%%%%%%%% %%%%% % %%%%%%% %%%%%%% %%%%%
% % %   %%% %%% % % %   %%%%%%%%%%%   %%%     %   %%%   %%%   %%%%%%%%% %%%   % %%%%% % %%%%%%% %%%%%
%%% % %%%%% %%% % % % % %%%%%%%%%%% %%%%% %%% %%% %%%%% %%%%% %%%%%%%%% %%%%%%% %%%%% % %%%%%%% %%%%%
%%%   %%%   %%% % % % %   % %%%   % %%%%% %%% %%% %     %%%%% %%%%%%%%%   %%%%%   %%% % %   %%%     %
%%%%%%%%% %%%%% %%% % %%% % %%%%% % %%%%%%%%% %%% %%% %%%%%%% %%%%%%%%% % %%%%% %%%%% % % %%%%%%% %%%
% %%%%%%%     %   %   %%% % %%%%%   %%% %%%     % %%%     %%%     %%%   %       %%%%%     %%%%% % %%%
% %%%%%%%%%%% %%% %%%%%%% % %%%%%%%%%%% %%% %%%%% %%%%%%% %%%%%%% %%%%% %%%%% %%%%%%%%%%% %%%%% % %%%
% %%%%% %     %%% %%%   %       %%%%%       %     %%% %%% % %%%   %%%%%     %     %%%%% % %%%       %
% %%%%% % %%% %%% %%% %%%%%%% %%%%%%% %%% %%% %%% %%% %%% % %%% % %%%%%%%%%%%%%%% %%%%% % %%% %%%%%%%
% %%%%% % %%% %%%     %     % %%%%%   %%% %   %%% %%%       %%% % %       %%%%%%% %     % %%% %%%%%%%
% %%%%% % %%%%%%% %%% % %%% % %%%%% %%%%%%% %%%%%%%%%%%%%%% %%% % % %%%%% %%%%%%% %%%%% % %%% %%%%%%%
% %%%%%   %%%%%   %%%   %   % % %%% %       %%% %%%%%%%%% %     % % %   % %       %%%%%   %%%   %%%%%
% %%%%% %%%%%%%%%%%%% %%% % % % %%%%% % %%%%%%% %%%%%%%%% %%%%%%% % % % % %%%%% %%%%%%% %%%%%%%%%%%%%
%       %%%       %%% %%% % %   %%%   % %%%%%       %%%     %%%%% % % % % %%%   %%%%%     %%%%%%% %%%
%%% %%%%%%% %%% % %%%%%%% %%%%% %%% %%% %%%%% %%%%% %%%%% %%%%%%% % % % % %%% %%%%%%% %%%%%%%%%%% %%%
%%%   %%%   %   % %       %%% % %%% %%% %   % %%% % % %%%       %   % % %   %     %   %%%%%%%     %%%
%%%%% %%% %%% %%% % % %%% %%% % %%% %%% % % % %%% % % %%%%%%% % %%%%% % %%% % %%% %%% %%%%%%%%% % %%%
%%%   %%% %%%   % % % %   %%% % %     %   %   %     %   %%%   %       %   % %   % %%% %%%   %%% % %%%
%%%%%%%%% %%%%% % %%% %%% %%% % %%%%% %%%%%%%%% %%% % %%%%% %%% %%% %%%%%%% %%%%% %%% %%%%% %%% %%%%%
% %%%%%   %%%%% % %%% %%%     %       %%%       %%%   %%%     % %%% %%%%%%% %     %%% %%%%%     %%%%%
% %%%%% %%%%%%% % %%% %%% %%%%% %%%%%%%%% %%%%%%%%% %%%%% %%% %%%%% %%%%%%% % % %%%%% %%%%% %%%%%%%%%
%   %   %%%%%   %     %   %%%%% %%% %%%   %%%%%%%   %%%   %%% %%%%%       %   % %%%   %%%     %%%%%%%
%%% % %%%%%%%%% %%%%%%% %%%%%%%%%%% %%%%%%%%%%%%% %%%%%%% %%% %%%%%%%%%%%%% %%%%%%%%%%%%%%%%% %%%%%%%
%%%   % %%%%%%%       %   %   %%% %   %%%%%       %%% %%% %%% %%%       %%% %%%%% %%%%%     % %%%%%%%
%%% %%% %%%%%%%%%%%%% %%%%% % %%% % % %%%%% %%%%% %%% %%% %%% %%% %%%%% %%% %%%%% %%%%% %%% % %%%%%%%
%%%       %%%%%%%%%%%       %       %         %%% %%%       %       %%%                 %         %%%
%%%%%%%%%%%%%%%%%%%%%%%%%%%%%%%%%%%%%%%%%%%%%%%%%%%%%%%%%%%%%%%%%%%%%%%%%%%%%%%%%%%%%%%%%%%%%%%%%%%%%
