%%%%%%%%%%%%%%%%%%%%%%%%%%%%%%%%%%%%%%%%%%%%%%%%%%%%%%%%%%%%%%%%%%%%%%%%%%%%%%%%%%%%%%%%%%%%%%%%%%%%%
% %%%   %%% %%%     %%%           %%%   %%%%%%%%%%%%%%%   %%% %%%%%%%%%%%%%%%%%%%       %%%         %
% %%%%% %%% %%% %%%%%%% %%%%% %%% %%%%% %%%%%%%%%%%%%%% % %%% %%%%%%%%%%%%%%%%%%% %%% %%%%%%% % %%%%%
%       %       %     % %%%   %     %%%   %%%%%%% %%%%% % %%% %%%%%%% %%%%%%%     %   %%% %%% % %%%%%
%%% % % % %%%%% % %%% % %%% %%% %%%%%%%%% %%%%%%% %%%%% % %%% %%%%%%% %%%%%%%%%%%%% % %%% %%% %%%%%%%
%%% % % % %%%%%   %%%   %   %%%   %%% %%% %%%%%%% %     %       %%%   %%%%%%%%%     %     %   %%%%% %
%%%%% % %%%%%%%%%%%%%%%%% %%%%%%% %%% %%% %%%%%%% % %%% %%%%%%% %%% % %%%%%%%%% % %%%%%%% %%% %%%%% %
%     %               %%%     %%%       %     %%%   %%% %%%%%%%     % %%%%%%%   % %%% %%%       %   %
% % %%%%%%%%% %%% %%% %%%%% %%%%%%%%%%% % %%%%%%% %%%%%%%%%%%%% %%%%% %%%%%%%%% % %%% %%%%%%%%% % %%%
% % %%%%%     %%% %%%       %%%%%%%%%%%   %%%%%%%   %%%%%   %%% %%%     %%%%%%% % %%%     %%%     %%%
% % %%%%%%%%% %%%%%%%%% %%%%%%%%%%%%%%% %%%%%%%%%%% %%%%%%% %%% %%% %%% %%%%%%% % %%% %%% %%% %%% %%%
% %   %%%%%%%   %%% %%% %         %%%%% %%%%%%%     %%%         %   %%% %%%%%   % %%% %%%     %%% %%%
%%% % %%%%%%%%%%%%% %%%%% %%% %%%%%%%%%%%%%%%%%%% %%%%% %%%%%%%%%%%%%%%%%%%%%%% % %%% %%%%% %%%%%%%%%
%%% % %   %%%%%%% %       %%% %       %%%%%%%%%%% %%%         %%%%%%%           % %%% %%%%%   % %%%%%
%%% % % % %%%%%%% % %%% %%%%% % %%%%% %%%%%%%%%%%%%%% %%%%%%% %%%%%%% %%% %%%%%%% %%%%%%%%%%% % %%%%%
%   % % %     %%%   %%% %%%   %     %   %%%%%%%%%%%%%       %       %   %       %   %%%   %%%     %%%
% %%% %%% %%% %%% %%%%%%%%% %%%%%%% %%% %%%%%%%%%%%%%%% %%%%% %%%%% % %%%%%%%%% %%% %%% %%%%%%% %%%%%
%   %     %   %%% % %%%%% %   %%% % %%%   %%%%%%%%%%%   %%%%%     %   %%%       %   %%% %%%%%%% %%% %
%%% %%%%%%%%%%%%% % %%%%% %%% %%% % %%%%% %%%%%%%%%%%%%%%%%%%%%%% %%%%%%% %%%%%%%%%%%%% %%%%%%%%%%% %
%%%     %%%%%%%   %         %     % %%%%%     %%%%% %%%%%%%%%%% % %%%   %     %%%%%%%%% %%%%% %%%   %
%%% %%% %%%%%%%%% % %%% %%% %%% %%% %%%%% %%% %%%%% %%%%%%%%%%% % %%%%% %%%%% %%%%%%%%% %%%%% %%% % %
%%%   %   %%% %%% % %%% %%% %   %%%   %%% %%% %     %%%%%%%%%%% %   %%% %%% %       %     %%% %%% % %
%%% %%% % %%% %%% % %%%%%%%%% %%%%% %%%%% %%% % % %%%%%%%%%%%%% %%% %%% %%% %%% % %%% %%% %%% %%% %%%
%   %%% %       %   %%%%% %%% %%%   %%%     %   %     %%%%%                 %%% %     %%%         %%%
%%% %%% %%%%%%% %%% %%%%% %%% %%% %%%%%%%%% %%% %%% %%%%%%% %%%%% %%%%% %%%%%%%%% %%%%%%% %%%%%%%%%%%
%%% %   %%%%%%%   % %%%     %         %%%%% %%% %%% %%%%%   %%%%% %%%   %%%%% %%%   %%%%%     %     %
%%%%% % %%%%%%%%%%% %%%%% % %%%%%%%%%%%%%%%%%%%%%%% %%%%% %%%%%%% %%% %%%%%%% %%%%% %%%%%%%%% % % %%%
%     %   %%% %     % %%% %     %%%     %%%%% %%%     %%% %%%%%   %%%         %%%     %%%%%%% % % %%%
% %%% %%% %%% % %%%%% %%%%%%% %%%%% %%% %%%%% %%% %%% %%%%%%%%%%%%%%% %%% %%% %%%%%%% %%%%%%% % % %%%
%   % %%% %%%     %%%   %%%   %%%   % %   %%%     % % %%%%%%%%%%%%%   %%% %%%   %%%%%   %%% %   %   %
%%% %%%%%%%%%%%%% %%% % %%% %%%%% %%% %%% %%% %%%%% % %%%%%%%%%%%%% %%%%%%%%%%% %%%%%%%%%%% % %%% % %
%%%   %%%%%%%%%   %%% %     %   % %           %%%%%   %%%%%%% %%%%%   %   % %%% %%%%%%%%%%%   %%% % %
%%% % %%%%%%%%% %%%%% %%% %%% % % % %%%%%%% %%%%%%%%%%%%%%%%% %%%%%%%%% % % %%% %%%%%%%%%%%%%%%%% % %
%   %   %%%%%%%   %%%   % %S  %   % %%%%%   %%%   %%%%%   %%% %   %%%   % %     %%%   %%% %%%%%   % %
%%%%%%% %%%%%%%%% %%% % %%%%%%%%% %%%%%%%%%%%%%%% %%%%%%% %%% % % %%% %%% %%%%% %%% %%%%% %%%%% %%%%%
%%%%%   %   %%%   %   %       %%% %%%%%%%%%%% %%% %%%%%%%   %   %     %%%     % %%% %%%   %%%   %%%%%
%%%%% %%% % %%% %%% %%%%%%% % %%%%%%%%%%%%%%% %%% %%%%%%%%% % %%% %%%%%%%%%%% %%%%% %%%%% %%% % %%%%%
%%%   %   %     %%%     %   % % %%%%%%%%%           %%%%%%%   %%% %%%%%%%%%           %       % %%%%%
%%%%% % %%%%%%% %%% %%%%% %%% % %%%%%%%%%%%%%%% %%% %%%%%%%%%%%%% %%%%%%%%%%%%% %%%%% % %%%%%%% %%%%%
%%%%% % %%% %%% %%% %%%   % %     %%%%%       % %%% %%%   %%%%%%% %%% %%% %%%   %%%     %%%%%%% %%% %
%%%%% % %%% %%%%%%% %%% %%% % %%%%%%%%% %%%%% %%%%% %%% %%%%%%%%% %%% %%% %%% %%%%%%%%%%%%%%%%% %%% %
%%%%% % %%%   %%%%%   % %%%   %%%%% %%% % %   %%%   %             % %   %     %%% %   %%%   %%% %%% %
%%%%% % %%% %%%%%%% %%% %%%%% %%%%% %%% % % %%%%% % %%% %%% % %%%%% % % % %%% %%% % % %%% % %%% %%% %
%       %   %       %%%   %%% %     %%% %       % % %%% %%% % %%%   % %   %%% %     %   % % %   %   %
% %%%%%%%%% % %%% %%%%% % %%% % % %%%%% %%%%%%% % % %%%%%%%%% %%%%% % %%%%%%%%% %%% %%% %%% % %%% %%%
%     %%%%%   %%% %%% % %   % % %       %%% %%%   % %%%%%       %%%     %   %   %%%   % %%%       %%%
% %%% %%%%%%%%%%%%%%% % %%% %%% %%%%%%% %%% %%%%%%% %%%%%%% % %%%%%%%%% % % % %%%%%%%%% %%% %%%%% %%%
% %%%   % %%%   %%%   %   %     %       %%% %%%%%   %   %%% % %%%     %   % % %%% %%%%%   % %%% % %%%
% %%%%% % %%% % %%%%% % %%%%%%%%% %%%%%%%%% %%%%% %%%%% %%% %%%%% %%% %%%%%%% %%% %%%%%%% %%%%% % %%%
%   %%% %     %     %   %     %%% % %%%%% %     % % %%%   %       %%%   %%%%%   %   %     %%%%%   %%%
% %%%%% % %%% %%%%% %%%%% %%% %%% % %%%%% % %%% % % %%%%% % %%%%%%%%%%% %%%%%%% %%% % %%%%%%%%% %%%%%
% %%%%% % %%% %%%   %%%%% %       % %       % % %   %%%%%   %   %%%%%%% %%%%%   %   %       %   %   %
%%%%%%% % %%%%%%%%% %%%%% %%% %%%%% % %%%%%%% % %%% %%%%%%% % % %%%%%%% %%%%% %%% %%%%%%%%% %%% % %%%
%%%%% % % % %%%%%%%   %%%   % %%%%% %     %%% %   % %   %%%   %     %%%   %%%   %   %%%%%%%   % %   %
%%%%% % % % %%%%%%%%% %%%%% %%%%%%% % %%%%%%% % %%% %%% %%%%% %%%%%%%%%%% %%%%% %%% %%%%%%%%% % %%% %
%       % %     %%%     %%% %%%       %%%%%   %     %%%   %   %%%%%%%%%%%   %%% %   %%%       % %%% %
%%%%% %%% %%%%% %%%%%%% %%% %%% %%%%%%%%%%% %%%%%%%%%%% %%% %%%%%%%%%%%%% % %%% % %%%%% %%%%%%% %%% %
%%%%% %%% %%%%%   %%%%%     %     %%%   %%% %%%%%%%%%%%     %%% %%%   %%% %   %   %%%%%   %%%%% %   %
%%%%% %%% %%%%% % %%%%%%%%% %%%%% %%% %%%%% %%%%%%%%%%% %%% %%% %%% %%%%% % %%% %%%%%%% % %%%%% % % %
%%%%%     %     %       %%% %%%%%   % %%%%%       %%%   %%% %%% %%%     % %     %%%%%%% %   %%%   % %
%%%%%%%%%%% %%%%% %%% %%%%%%%%%%%%% % %%%%%%% %%% %%% %%%%% %%% %%%%%%% % %%% %%%%%%%%%%% %%%%%%%%% %
%%%     %%%     % %   %%% %%%   %%% %     %%%   %     %%%%%       %%%%%   %%% %%%%%%% %%% %%%   %   %
%%%%% % %%%%%%%%% %%%%%%% %%% %%%%% %%% % %%% %%%%%%%%%%%%%%%%%%% %%%%%%% %%%%%%%%%%% %%% %%%%% % %%%
%     %   %%%%%%% %%%%%%% %         %%% % %   %%%%%%%%% %%%   %   %%% %%% %%%%% %%%     % %%%   % %%%
% % %%%%%%%%%%%%% %%%%%%% % %%%%%%%%%%%%% % %%%%%%%%%%% %%% %%% %%%%% %%%%%%%%% %%%%% %%% %%% %%% %%%
% %           %       %     %%%   %%% %%%   %%% %%%%%%% %%%     %       %%%%%     %   %%% %%%       %
% %%% %%%%%%% % % % %%% %%%%%%% %%%%% %%% %%%%% %%%%%%% %%% %%%%%%% %%%%%%%%% %%% % %%%%% %%% %%%%% %
% %%% %%%   %   % % %   %   %%%   %%%   % %%%%%   %%% %     %%%     %%%%%     %%%   %%%   %   %%%%% %
% %%%%%%% %%% %%% %%% %%% %%%%%%% %%%%% % %%%%% % %%% % %%%%%%% %%%%%%%%%%%%% %%% %%%%%%% %%% %%%%%%%
%   %%%%% %%% %%%     %   %%%%%%%   %%%     %   % %%%     %%%         %%%%%   %   %%% %%%   %     %%%
% %%%%%%% %%%%%%%%%%%%% % %%%%%%% %%%%% %%% %%%%% %%%%%%% %%% %%%%% % %%%%% %%%%%%%%% %%%%% %%%%% %%%
% %%%       %%%     %%% %         %%%%% %%%   %%% %%%%% % %%% %%%%% % %%% %     %%%%%       %%%%%   %
% %%% %%% %%%%%%% % %%%%% %%%%%%% %%%%%%%%%%% %%% %%%%% % %%%%%%%%% %%%%% % %%% %%%%%%%%% %%%%%%%%% %
%     %%% %%%%%%% %   %%%   % %%%     %%% %%%       %%% %   %%%     %%%   %   %   %%%%%   %%% %%%   %
%%%%%%%%% %%%%%%%%% %%%%%%% % %%% %%% %%% %%%%%%%%%%%%% %%% %%% %%%%%%%%% % %%% %%%%%%% %%%%% %%%%%%%
%%%       % %%%   % %%%   %   %%% %%%       %%%%%%%%%%%       %   %%% %%%   %%% %%%%%   %%%       %%%
%%% %%%%%%% %%% % % %%%%% % %%%%% %%%%% %%% %%%%%%%%%%% %%%%% %%% %%% %%%%%%%%% %%%%%%% %%% %%%%% %%%
%%% %%%%%       %   %%%%% % %%%   %%%%% %%%   %%%     % %%%   %%%           %%%     %%%   % %%% %   %
%%% %%%%%%% %%%%% %%%%%%% % %%%%%%%%%%%%%%% % %%% %%% %%%%% %%%%% %%%%%%%%% %%% % %%%%%%% % %%% % % %
%   %%% %%% %     %%%%%     % %%%       %%% %     %   %%%         %%%%% %%% %%% % %%%   %   %%% % % %
%%% %%% %%% %%%%%%%%%%% %%%%% %%% %%%%% %%%%% % %%% %%%%% %%% %%% %%%%% %%% %%% % %%% %%%%% %%% % %%%
%%% %%%               %       %   %%%%% %     % %%% %     %%% %%% %%%%%   %     % %%%   %%%     % %%%
%%% %%%%% %%% %%%%%%% %%%%%%% % %%%%%%% %%% %%%%%%% %%%%% %%% %%%%%%%%%%% % %%%%% %%%%% %%%%% %%% %%%
%     %%% %%%   %%%%% %   %%% % %%%%%%%     %%%%% % %%%%% %%%   %       %   %%%%%         %%% %%%   %
% %%%%%%%%%%%%%%%%%%% % % %%% % %%%%%%%%% %%%%%%% % %%%%%%%%% %%% %%%%% %%%%%%%%%%%%%%%%% %%% %%% % %
% %%%%% %%%%%%%%%       %     %     %%%   %%% %%%   %%%%%%%%% %   %%% %   %%%         %%% %%%   % % %
% %%%%% %%%%%%%%%%%%% %%%%%%%%% %%%%%%% %%%%% %%% %%%%%%%%%%%%% %%%%% %%% %%%%% %%%%% %%% %%%%%%% %%%
% %       %     %%%%% %%%%%%%%%     % % % %%%     %%% %%%       %%%     % %%%%% %%%%%   %   %%%   %%%
% %%% %%%%% %%% %%%%%%%%%%%%%%% %%% % % % %%%%%%% %%% %%% %%%%% %%%%% %%% %%%%%%%%%%%%% %%% %%% %%%%%
%   %       %%%     %%%   %%%%% %%% % %     %%%%% %%% %%%   %   %%%%%     %!  %%%   %%%       % %%%%%
%%% %%% %%% %%% %%% %%% % %%%%%%%%% % % %%% %%%%% %%% %%%%% %%%%%%%%%%%%% %%% %%% % %%%%%%% %%% %%%%%
% %   % %%% %   %   %   %     %%%   %   %%% %%% %       %%%   %%% %%%%%%% %%%   % %     %%% %%% %%%%%
% %%% %%%%%%% %%% %%%%% %%% % %%% %%%%%%%%% %%% % %%%%% %%%%% %%% %%%%%%% %%% % %%% %%% %%%%%%% %%%%%
%   %   %%%%%   %   %%%   % % %%%   %%%%%%% %%%   %%% % %%%%% %           %   %   % %     %%%%%   %%%
% %%%%% %%%%%%% %%% %%%%%%% % %%%%% %%%%%%%%%%% %%%%% % %%%%% % %%% %%%%%%% % %%% % %%%%% %%%%%%% %%%
%     % % %%%   %   %%%     %   %%%       %%%   %%%%%     %   % %%%         % %%%   %%%       %   %%%
%%%%% % % %%% %%% %%%%% %%%%%%%%%%%%% %%% %%% %%%%%%% %%% % %%% %%%%%%% %%% %%%%%%%%%%%%%%%%% % %%%%%
%%%%%     %   %%%       %%%%%%%%%     %%% %%% %%%     %%% % %     %%%%% %%% %%%%%%%   %%%   %   %%%%%
%%%%%%%%% % %%%%% %%%%% %%%%%%%%% %%% %%%%%%%%%%% %%%%%%% % %%% %%%%%%% %%% %%%%%%% %%%%% % % %%%%%%%
%%%%%%%%%   %%%   %%%             %%%   %%%%%%%       %%%   %%% %%%%%%% %%%   %%%         %   %%%%%%%
%%%%%%%%%%%%%%%%%%%%%%%%%%%%%%%%%%%%%%%%%%%%%%%%%%%%%%%%%%%%%%%%%%%%%%%%%%%%%%%%%%%%%%%%%%%%%%%%%%%%%
