%%%%%%%%%%%%%%%%%%%%%%%%%%%%%%%%%%%%%%%%%%%%%%%%%%%%%%%%%%%%%%%%%%%%%%%%%%%%%%%%%%%%%%%%%%%%%%%%%%%%%
%     %   %%%              S%%%%%%%%%%%%%%%%%   %%%     %%%     %%%%% %%% %%% %%% %%%%%%% %%%%%%%%%%%
%%% %%% % %%% %%%%%%%%%%%%%%%%%%%%%%%%%%%%%%% %%%%% %%% %%%%% % %%%%% %%% %%% %%% %%%%%%% %%%%%%%%%%%
%   %%% %     %%%%%     %%%%%   %%%%%%%%%         %   %       %   %%%     %%%             %%%%%%%%%%%
% %%%%% %%%%%%%%%%%%% % %%%%% % %%%%%%%%%%%%%%% %%% %%% %%%%%%%%%%%%%%% %%%%%%% %%% % %%%%%%%%%%%%%%%
%       %%%     %     % %     %   %%%%%%%%%%%%%     %%%                 %%% %%% %%% %   %%%%%%%%%%%%%
%%%%% %%%%% % % %%% %%% % %%%%% %%%%%%%%%%%%%%%%% %%%%%%%%%%%%%%% %%% %%%%% %%% %%%%%%% %%%%%%%%%%%%%
%%%%% % %%% % %   % %%%   %     %%%   %%%     %%%             %%% %%%     %       %%%   %%%   %%%%%%%
%%%%% % %%%%% %%% % %%%%%%% %%%%%%%%% %%%%%%% %%%%% %%%%%%%%%%%%%%%%%%% %%% %%%%%%%%% % %%% %%%%%%%%%
%%%   %       % %   %%%%%   %           %%%%%       %%%%%         % %%%         %%%   %   % %%%%%%%%%
%%% %%% %%%%%%% %%%%%%%%% %%% %%%%% %%%%%%%%% %%%%%%%%%%% %%%%%%% % %%% %%%%% %%%%% % %%% % %%%%%%%%%
%       %%%     %%%%%%%%%   %   %%%   %%%%%%%   %%%%%   % %     % %   %   %%% %     % %%%     %%% %%%
%%% %%%%%%% % %%%%%%%%%%%%% %%%%%%%%% %%%%%%% %%%%%%% %%% %%%%% % %%% % %%%%%%% % %%% %%%%% %%%%% %%%
%%% %%%%%   % %%%   %%% %%%       %%%   %%%   %%% %%% %%% %%%%% % %%% % %%% %%% % %%%   %%% %%%%%   %
%%%%%%%%% %%% %%% %%%%% %%%%%%%%% %%% % %%%%% %%% %%% %%% %%%%% % %%% % %%% %%% %%%%% %%%%% %%%%%%% %
%%%%% %%% %%%     %%% %         % %%% %   %%%   %     %     %%%   %%%   %%%     %%%%% %%%%%     %%% %
%%%%% %%%%%%% %%%%%%% % %%% %%% % %%% %%% %%%%% % %%%%% %%% %%%%% %%% %%%%% %%%%%%%%%%%%%%%%%%% %%% %
%       %%%       %     %%% %   % %   %%% %%%   %   %%% %%% %%%%% %   %%%%% %%%%% %%%%%%%   % % %   %
% %%% %%%%% %%%%% % %%%%%%%%% %%% % %%%%%%%%%%% %%% %%% %%%%%%%%% %%%%%%%%% %%%%% %%%%%%% % % % % % %
% %%% %%%   %%%%%   % %%%     %%% % %%% %%% %%% %   %%%   %%% %%%       %     %%%         % %     % %
% %%%%%%% %%%%%%% %%% %%% %%% %%% % %%% %%% %%% % % %%%%% %%% %%%%%%%%% % %%% %%% %%%%% %%% %%%%%%% %
%   %%%   %%%     %   %%% %     %   %   %%% %%%   % %     %%%       %%%   %%% %%% %%%%%   %       % %
% %%%%% %%%%% %%% %%% %%% % %%%%%%% %%% %%% %%%%% %%% %%%%%%% %%%%% %%%%%%%%%%%%% %%%%%%%%%%% %%% %%%
% %%% % %%%%% %%%   % %   % %%%%%!% %   %     %%% %%% %%%       %%%   %   %%%   % %%%%%%%%%%% %   %%%
% %%% % %%%%%%%%%%% % % % %%%%%%% % % %%% %%% %%% %%% %%% %%%%% %%% %%% % %%% % % %%%%%%%%%%%%% %%%%%
%           %%%%%%%   % % %%%       %     %   %   %%%     %%%%% %   %%% % %   % %   %%% %%% %%% %%%%%
%%%%% %%%%% %%%%%%%%%%% %%%%%%% %%%%%%% %%% %%% %%%%% %%% %%%%%%% %%%%% % % %%% % %%%%% %%% %%% %%%%%
%%%%% %%%       %%%%%   %%%%%%% %%% %%% %%% %   %%%%% %%% %%%%%   %%%   %   %%%   %         %%%     %
%%%%%%%%% %%%%% %%%%% %%%%%%%%% %%% %%%%%%% % %%%%%%%%%%%%%%%%% %%%%% %%%%%%%%%%%%% %%%%%%% %%%%%%% %
%%%%%%%   %%% % %%%         %%%         %%%   %%%   %%% %%%%%   %%%   %   %%%%%%%   %%%     %   %%% %
%%%%%%% %%%%% % %%%%% %%%%% %%% %%%%%%% %%%%% %%% %%%%% %%%%% % %%% %%%%% %%%%%%% % %%%%% %%% % %%% %
%%%%%%% %%%%% % % %%%   %   %%% %%%   %   %%%     %%%   %     %     %       % %   % %%%%% %%% %     %
%%%%%%% %%%%% % % %%%%%%% %%%%% %%% %%%%% %%%%% %%%%% % % %%% %%%%%%% %%%%% % % %%%%%%%%% %%% % %%% %
%   %   %%%%% %     %%%%% %%%   %%% %   % %     %     % % %%%   %%%%% %       %   %%%%%       % %%% %
% % % %%%%%%% %%%%% %%%%% %%% %%%%% % % % % %%%%% %%%%% %%%%% %%%%%%% %%%%%%% %%% %%%%%%%%% %%% %%%%%
% %   %%%     %%%%%     % %%% %%%%% % %   % %     %%%%% %%%%% %%%     %%%%%%%   % %   %%%   %%% %%%%%
%%%%%%%%% %%% %%%%%%%%% % %%%%%%%%% % %%% %%% % %%%%%%% %%%%% %%%%%%% %%%%%%% %%% % % %%%%% %%%%%%%%%
%%%%%%%   %   %%%   %   % %%%%%       %%% %%% % %%%   %   %   % %%%%%   %%%   %%% % %   %%%   %%%%%%%
%%%%%%%%% %%% %%%%% % %%% %%%%% %%%%%%%%% %%% % %%% %%%%% %%% % %%%%% % %%%%%%%%% % %%% %%%%% %%%%%%%
%%% %%%   %%% %%%%% % % %           %%%   %   % %%% %%%%% %%% %       %   %%%%%%% % %%%   %%% % %%%%%
%%% %%% %%%%%%%%%%% % % %%%%%%%%%%%%%%%%% % %%%%%%% %%%%% %%% %%% %%%%%%%%%%%%%%% %%%%% %%%%% % %%%%%
%   %%%     %%%%%%%     %%% %%% %%%%%%%%%   %%%%%         %       %%%%%%%%%%%%%%% %%%   %%%   %   %%%
%%% %%% % % %%%%%%% %%% %%% %%% %%%%%%%%%%%%%%%%% %%%%%%%%% %%%%% %%%%%%%%%%%%%%% %%% % %%% %%%%% %%%
%%%     % % %%%%%   %%%           %%%%%%%%%   %%% %%%%% %%% %%%%%       %%%%%   % %%% %       %%% %%%
%%%%% %%% %%%%%%%%% %%%%%%%%%%% %%%%%%%%%%%%% %%% %%%%% %%% %%%%%%%%% %%%%%%% % % %%%%% %%%%%%%%% %%%
%%%%%   %     %%%%%   %%%%%     %%%   %%%%%   %%%     %     %%%%%%%%% %%%%%   % %   %%% %%%%%%%     %
%%%%% %%%%%%% %%%%%%% %%%%% %%%%%%% %%%%%%% % %%%%%%% %%%%%%%%%%%%%%% %%%%%%% % %%% %%% %%%%%%%%% %%%
%%%%% %%%%%%% %%%   % % %%% %%%%%           % %%%%%%%     %%% %%%%%       %%% %     %   %   %     %%%
%%%%%%%%%%%%% %%% % % % %%%%%%%%% %%%%%%%%% % %%%%%%%%%%% %%% %%%%%%%%% %%%%% %%%%%%%%% % % % %%% %%%
%%%%%%%%%%%       %       %%%%%   %     %%% %       %%%%% %   % %%%%%   %%%   %%% %%%%%   %   %%%   %
%%%%%%%%%%% %%% %%%%% %%%%%%%%% %%% % %%%%% %%% %%%%%%%%% % % % %%%%%%% %%% %%%%% %%%%%%%%%%% %%%%%%%
%%%%%%%%%   %%% %%%%% %%%%%%%   %   %   %   %%% %%%%%   %   %   %   %%% %%%   %       %%%%% %   %%%%%
%%%%%%%%% %%%%%%%%%%%%%%%%%%% %%% %%%%% % %%%%%%%%%%% %%%%%%%%% %%% %%% %%% % %%% %%% %%%%% % %%%%%%%
%%%%%     %   %%%   %%%   %   %%%   %%% % %%%         %%%%% %%%       % %%% % %%% %%%         %%% %%%
%%%%%%% %%% %%%%%%% %%%%% % %%%%%%% %%% % %%% %%% %%% %%%%% %%%%% %%% %%%%%%% %%% %%%%%%% %%%%%%% %%%
%%%%%%% %%% %%%     %%%%% %   %%% % % % %     %%% %%% %%%   %%%%% %%%   %%%%% %%%   %%%%% %%%   % %%%
%%%%%%% %%% %%%%% %%%%%%% %%% %%% % % % %%% %%%%% %%% %%%%% %%%%%%%%%%% %%%%% %%%%% %%%%%%%%% % % %%%
%%%%%%% %   %%%%%         %%%   %     % %%%     % %%%   %%%   %%%%%%%%%   %%%     %   %%%%%   %   %%%
%%%%%%% % %%%%%%% %%% % %%%%%%% %%%%%%% %%%%%%%%% %%%%% %%%%% %%%%%%%%%%% %%% %%% %%% %%%%%%% % %%%%%
%%%%%%%   %%%%%   %   % %%% %   %%%%%%% %%%%%%%%% %%%     %%%     %   %%%   % %%% %       %%% % %%%%%
%%%%%%%%% %%%%% %%% %%% %%% % %%%%%%%%% %%%%%%%%% %%% %%% %%%%% %%% % %%%%% % %%% %%%%%%% %%% %%%%%%%
%%%%%%%%% %%%%% %   %%% %%%   %         %%%%%%% %   % %%% %%%%%   % %       % %   %%%%%%%     %%%%%%%
%%%%%%%%%%%%%%% % % %%%%%%% %%% %%% % %%%%%%%%% %%% %%%%%%%%%%% % % %%%%%%%%%%% %%%%%%%%%%% %%%%%%%%%
%%%%%%%%%%% %%% % % %       %   %%% % %%%%%%%%%   %             % %       %%%%%         %%% %%%%%%%%%
%%%%%%%%%%% %%% % % % %%%%%%% %%%%%%% %%%%%%%%%%% %%%%%%%%%%%%%%% %%%%%%% %%%%%%%%% %%% %%%%%%%%%%%%%
%%%%%           % % % %       %%%%%%% %%%%%%%%%%% %%% %%%%%   %%%   %%%%%   %%%%%%% %%%   %%%%%%%%%%%
%%%%%%%%%%%%% %%% %%% %%% %%%%%%%%%%% %%%%%%%%%%% %%% %%%%% %%%%%%% %%%%% %%%%%%%%%%%%%%% %%%%%%%%%%%
%%%%%%%%%%%%% %   %%% %%% %       %   %%%%%%%%% %     %%%   %%%         % %%%   % %%%%%   %%%%%%%%%%%
%%%%%%%%%%%%%%% %%%%% %%%%% %%%%% %%% %%%%%%%%% % %%% %%% %%%%%%% %%%%% % %%% % % %%%%% %%%%%%%%%%%%%
%%%%%%%%%%% %%%         %%% %%%%%   % %%%%%%%   % %%%     %       %%%   %     % %       %%%%%%%%%%%%%
%%%%%%%%%%% %%%%% %%%%%%%%% %%%%%%% % %%%%%%% %%% %%%%%%% % %%% %%%%%%% %%%%%%% %%%%% % %%%%%%%%%%%%%
%%% %%%%%%%   %%% %   %%%         %     %%%   %     %   % %   % %%% %%% %%%%%   %%%%% %   %%%%%%%%%%%
%%% %%%%%%% % %%% % %%%%%%%%%%%%% %%%%% %%% %%% %%%%% % % %%% %%%%% %%%%%%%%% %%%%%%%%%%% %%%%%%%%%%%
%           % %%%   %%%%%     %%%   %   % %     %%%%% %   %   %%%   %   %%%   %%%%%%%%%%%   %%%%%%%%%
%%% % %%%%%%%%%%% %%%%%%% %%% %%%%% % %%% % %%%%%%%%% %%% % %%%%% %%% % %%%%% %%%%%%%%%%%%% %%%%%%%%%
%   % %%%%%%%%%%% %%%   % % % %     % %   % %%%       %   % %%%       %   %%%   %%%%%%%       %%%%% %
% %%%%%%%%%%%%%%% %%% % % % % % %%%%% %%% % %%% %%%%% %%%%% %%% %%%%%%%%% %%%%% %%%%%%% %%%%% %%%%% %
%   %%% %%%%%%%%%     %   %     %%%   %%%   % % %     %%%%%     %       %     %   %%%%%   %   %%%%% %
%%% %%% %%%%%%%%%%%%%%%%%%%%%%%%%%% %%%%% %%% % % %%%%%%%%%%%%%%%%%%% % %%%%% %%% %%%%%%% %%%%%%%%% %
%%% %%%       %%%         %%%%%   % %%%%%     % % %%%%%%%   %%% %%%%% %   %%%   % %   %%%   %%%   % %
%%% %%% %%%%%%%%% %%%%% % %%%%% % % %%%%%%%%%%% %%%%%%%%% %%%%% %%%%%%% % %%%%% % % % %%%%% %%% % % %
%   %%%     %%%%%   %   %       % %             %%%%%                 % % % %   % % % %%%%%     %   %
% % %%% %%% %%%%%%% % %%% %%%%%%%%% %%%%%%%%%%% %%%%% %%%%%%%%% % %%% % % % % %%% % %%%%%%% %%% %%%%%
% % %%% %%%   %%%%% % %   %%%%%%%%% %%%   %%% %     % %%%%%   % % %%%   %   %   %   %%%     %%%     %
%%% %%% %%%%% %%%%%%% %%% %%%%%%%%%%%%%%% %%% %%%%% %%%%%%% % % % %%%%% %%% %%% % %%%%% %%%%%%%%%%% %
%%% %%% %%%         % %%% % %%%%% %%%%%%%     %%%%%   %     %   % %%%%% %%% %%% % %%%   %%%         %
%%% %%%%%%% % %%%%% % %%% % %%%%% %%%%%%%%% %%%%%%%%% %%%%% %%%%% %%%%%%%%%%%%% % %%% %%%%% %%%%%%% %
%           % %%%     % % %             %%%   %%%%%%% %     %%%   %%%%%%%%%%%%% % %   %%%   % %%%%% %
% % %%%%% %%%%%%%%% %%% % %%%%% %%%%% % %%%%% %%%%%%% % %%% %%%%%%%%%%%%%%%%%%% % %%%%%%% %%% %%%%% %
% %     % %%%%%%%%% %%%       %   %%% % %%%%%   %%% %   %%% %%%%%%%%%%%%%%%     %         % %       %
% %%%%% %%%%%%%%%%%%%%%%%%%%% % %%%%%%% %%%%% %%%%% %%%%%%% %%%%%%%%%%%%%%% % %%%%%%%%%%%%% % %%%%%%%
%   %%%       %%% %%% %%%%%%% % %%%%%%%   %     %%% %       %%%%%%%%%%%%%%% % %%% %       % %     %%%
%%% %%%%% %%% %%% %%% %%%%%%% %%%%%%%%% % %%%%% %%% % %%%%%%%%%%%%%%%%%%%%% %%%%% % %%% % % %%%%% %%%
%%%   %%% %%% %%%       %%%%%           %       %%% %     %%%%%%%%%%%%%%%%%         %   %       % % %
%%%%% %%% %%%%%%%%% %%%%%%%%%%%%% %%%%% %%%%%%% %%% % %%%%%%%%%%%%%%%%%%%%% %%%%%%%%% %%%%% %%%%% % %
%%%%% %%%   %%% %%%   %%%   %%%   %%%%% %%%%%%% %%% % %%%%%%%%%%%%%%%%%%%%% %       %   %   %%%%%   %
%%%%% %%% %%%%% %%% % %%% %%%%%%%%%%%%%%%%%%%%% %%% % %%%%%%%%%%%%%%%%%%%%% % % %%% %%% %%%%%%%%%%% %
%%% %   % %         %               %%%       %   %     % %%%%%%%%%%%%%%%   % % %%% %%% %%%     %%% %
%%% %%% % % %%%%%%% %%%%%%%%% %%%%% %%% %%%%% %%%%% %%% % %%%%%%%%%%%%%%% %%% %%%%% %%% %%% %%% %%% %
%%%     %     %%%%%       %%% %%%%%     %%%%%       %%%   %%%%%%%%%%%%%%%     %%%%% %%%       %     %
%%%%%%%%%%%%%%%%%%%%%%%%%%%%%%%%%%%%%%%%%%%%%%%%%%%%%%%%%%%%%%%%%%%%%%%%%%%%%%%%%%%%%%%%%%%%%%%%%%%%%
