%%%%%%%%%%%%%%%%%%%%%%%%%%%%%%%%%%%%%%%%%%%%%%%%%%%%%%%%%%%%%%%%%%%%%%%%%%%%%%%%%%%%%%%%%%%%%%%%%%%%%
%%% %%%   % %%%%% %%%%%   %%% %%%%%%%%%%%%%%%%%%%%%%%%%%%%%%%%%%%%%%%%%%%%%%%%%%%%%%%%%%%%%%%%%%%%%%%
%%% %%% % % %%%%% %%%%%%% %%% %%%%%%%%%%%%%%%%%%%%%%%%%%%%%%%%%%%%%%%%%%%%%%%%%%%%%%%%%%%%%%%%%%%%%%%
%       %             %     %   %%% %%%%%%%%%%%%%%%%%%%%%%%%%%%%%%%%%%%%%%%%%%%%%%%%%%%%%%%%%%%%%%%%%
%%% %%%%% %%% %%%%%%% % %%% %%% %%% %%%%%%%%%%%%%%%%%%%%%%%%%%%%%%%%%%%%%%%%%%%%%%%%%%%%%%%%%%%%%%%%%
%%%   %   %%% %%%%%   % %%%           %%% %%%%%%%%%%% %%%%%%%%%%%%%%%%%%%%%%%%%%%%%%%%%%%%%%%%%%%%%%%
%%%%% %%%%%%% %%%%% %%% %%%%%%%%%%% %%%%% %%%%%%%%%%% %%%%%%%%%%%%%%%%%%%%%%%%%%%%%%%%%%%%%%%%%%%%%%%
%%%%% %%%%%   %%%   %%%   %%%%%%% % %%%       %%%%%%%   %%%%%%%%%%%%%%%%%%%%%%%%%%%%%%%%%%%%%%%%%%%%%
%%%%% %%%%%%%%%%% %%%%% %%%%%%%%% % %%%%% % %%%%%%%%% %%%%%%%%%%%%%%%%%%%%%%%%%%%%%%%%%%%%%%%%%%%%%%%
%%%   %   %%%%%   %     %%%%%%%     % %%% % %%%%%     %%%   %%%%%%%%%%%%%%%%%%%%%%%%%%%%%%%%%%%%%%%%%
%%% % % % %%%%%%% % %%% %%%%%%% %%%%% %%% % %%%%%%%%% %%% % %%%%%%%%%%%%%%%%%%%%%%%%%%%%%%%%%%%%%%%%%
%%% %   %   %%%%%   %%% %%%%% % %   % %%% %   %%%%%%%     %   % %%%%%%%%%%%%%%%%%%%%%%%%%%%%%%%%%%%%%
%%% %%%%%%% %%%%%%% %%%%%%%%% % % % % %%% %%% %%%%%%% %%% % % % %%%%%%%%%%%%%%%%%%%%%%%%%%%%%%%%%%%%%
%   %%% %%%   %     %%%%% %%%     %   %   %   %%% %%% %%% % %     %%%%%%% %%%   %%%%%%%%%%%%%%%%%%%%%
%%% %%% %%%%% %%%%%%%%%%% %%% %%%%%%% %%%%% % %%% %%% %%%%% % %%% %%%%%%% %%% %%%%%%%%%%%%%%%%%%%%%%%
%%% %     %%% %%%%%%%%%   %%% %%%     %     % %%% %%% %%%%% % %%%   %%%%%     %%%%%%%%%%%%%%%%%%%%%%%
%%% % %%%%%%% %%%%%%%%%%% %%%%%%% %%% % %%% %%%%% %%% %%%%% %%%%% %%%%%%% %%%%%%%%%%%%%%%%%%%%%%%%%%%
% %   %%%       %%% %%%   %%%%%%% %%% %   % %%%%%   %     % %%%   %%% %%% %%%%%%%%%%%%%%%%%%%%%%%%%%%
% %%% %%% %%%%% %%% %%% % %%%%%%%%%%% %%% % %%%%% %%% %%%%% %%% %%%%% %%% %%%%%%%%%%%%%%%%%%%%%%%%%%%
%       %   %%% %%%     % %%%%% %%%%% %%% %       %   %%%%% %   %       % %%%%%%%%%%%%%%%%%%%%%%%%%%%
% %%%%% %%% %%% %%% %%%%% %%%%% %%%%% %%% % %%%%%%% %%%%%%% %%% % %%%%% % %%%%%%%%%%%%%%%%%%%%%%%%%%%
% %%%     %   % %%%   %     %%% %%%%%     % %%%%%     %%%     %   %%%%% %   %%%%%%%%%%%%%%%%%%%%%%%%%
%%%%%%%%%%%%% %%%%% % %%%%%%%%% %%%%%%%%%%% %%%%% %%%%%%% %%% %%% %%%%% %%% %%%%%%%%%%%%%%%%%%%%%%%%%
%%%%%%%%%     %%%%% %         % %%% %%%       %   %%%%%   %%% %%% %%%       %%%%%%%%%%%%%%%%%%%%%%%%%
%%%%%%%%% %%%%%%%%%%%%% %%% % % %%% %%%%% %%%%% %%%%%%%%%%%%% %%%%%%% %%% %%%%%%%%%%%%%%%%%%%%%%%%%%%
%%%%%%%   % %     %%%%%   % %       %%%%% %%%%%   %%%%%%%%%%%   %%%   %%% %%%   %%%%%%% %%%%%%%%%%%%%
%%%%%%% %%% % %%% %%%%%%% % %%%%% %%%%%%% %%%%%%% %%%%%%%%%%%%% %%%%% %%% %%%%% %%%%%%% %%%%%%%%%%%%%
%       %%%   %%%     %%% % %%%%% %%% %%% %%%%%%%   %%%         % %%% %%% %%%%%   %%%%% %%% %%%%%%%%%
% %%%%% %%%%% %%% %%%%%%% % %%%%% %%% %%% %%%%%%% %%%%%%%%% %%% % %%%%%%% %%%%% %%%%%%% %%% %%%%%%%%%
%     %   %%% %%%       % %   %%% %         %     %%%     % %%%     %%%         %%%         %%%%%%%%%
%%%%%%% % %%% %%%%% %%% % %%% %%%%% %%%%%%%%% %%%%%%% %%% % %%%%%%%%%%%%%%% %%% %%% %%% %%%%%%%%%%%%%
%%%     % %%%   %%%   %   % %       %         %%% %%% %       %%%     %%%   %%%   % %%% %%%%%%%     %
%%% %%%%%%%%% %%%%%%% %%%%% %%%%%%% % %%%%%%%%%%% %%% %%% %%% %%% %%% %%%%%%%%%%%%% %%% %%%%%%%%% %%%
%         %%% %%%%%   % %%% %%%%%%% % %%%   %%%%%   %   % %%%   % %%% %%%%%         %   %     %%% %%%
% %%%%%%% %%%%%%%%% %%% %%% %%%%%%% % %%%%% %%%%% % %%% % %%%%%%% %%% %%%%% %%%%%%%%% % % %%% %%% %%%
% %   %   %%%%%                !%%% %       %     %   % % %%%   %   %       % %%%%%%% %   %%% %%% %%%
% % %%% %%%%%%%%% %%%%%%%%% %%% %%%%%%%%%%% %%% %%% %%% % %%% % % %%%%%%%%% % %%%%%%% %%% %%%%%%% %%%
%   %   %%%%%%%%% %%%%%     %%%   %%%     %     %   %%% %   % %   %%%%%%%%%   %%%     %   %         %
%%%%% %%%%%%%%%%% %%%%%%%%%%%%%%%%%%% %%%%%%%%%%%%% %%% %%%%% %%% %%%%%%%%% %%%%% %%%%%%%%% % %%%%%%%
%     %%%%%       %%% %   %%%%%       %%%%%%%%%%%%% %%%   %%% %%%       %%% %%%             % %%%%%%%
% %%%%%%%%%%% %%% %%% % % %%%%% %%% % %%%%%%%%%%%%% %%%%% %%% %%%%%%% %%%%%%%%%%% %%%%%%%%%%% %%%%%%%
%           % %%%   %   %       %%% %   %%% %       %   %   %   %%%%% %%%%%%% %%% %%%%%%%   %   %%% %
%%%%% %%%%% %%%%%%%%% %%%%%%%%%%%%% %%%%%%% % %%%%%%%%% %%% % %%%%%%%%%%%%%%% %%%%%%%%%%%%% %%% %%% %
%%%%% %%%   %%% %%%   %%% %%%%%%%   %%%%%   %   %%%%%%% %%%   %%%%% %%%%%%%%%   %%%         %%%     %
%%%%%%%%% %%%%% %%% %%%%% %%%%%%% %%%%%%%%% %%% %%%%%%% %%%%%%%%%%% %%%%%%%%% % %%%%% %%% %%%%%%% % %
%   %%%             %%%     %%%         %%%     %%%     %%% %%%       %%%%%   %       %%% %%% %%% % %
%%% %%%%% %%%%%%% %%%%% % %%%%% %%%%%%% %%%%% %%%%%%% % %%% %%% % %%% %%%%% %%% %%%%%%%%% %%% %%%%% %
%     %%%     %%%       % %%%   %   %%%   %%% %%%     % %%%     %   % %     %   %   %%%   %   %%%%% %
% %%%%%%%%%%% %%%%%%%%% %%%%%%% % %%%%% %%%%% %%% %%%%% %%% %%%%%%% % %%% %%%%%%% % %%% %%% % %%%%% %
%   %%%%% %%% %%%%%     %%% %%%   %%%   %%% % %%% %%% % %   %%%%%%% %     %       % % % %   %     % %
% % %%%%% %%% %%%%%%%%%%%%% %%%%%%%%% % %%% % %%% %%% % % %%%%%%%%% %%%%% % %%%%%%% % % %%% %%%%% % %
% %           %   %%%%%%%%%           % %   %     %     % %%%%%%%%% %%%%% %     %   %       %%%%% % %
% %%%%%%% %%% % % %%%%%%%%%%% % %%% %%% % %%% %%%%% %%%%%%%%%%%%%%% %%%%%%%%%%% % %%%%%%%%% %%%%%%% %
%   %%%%% %%% % %       %%%   % %%% %%%   %%% %%%%%   %       %%% %     %%%   % %S%%%     %   %   % %
%%% %%%%%%%%%%% %%% %%% %%% %%%%%%%%%%%%%%%%%%%%%%%%% % %%%%% %%% % %%% %%% %%% %%%%% %%% %%% % % % %
%%% %%%%%%%%%%% %%% %%%     %   %     %%%%% %%%   %%%   %%% % % %   %%%     %%%       %     % % %   %
%%%%%%%%%%%%%%% %%%%%%%%%%%%% % % %%% %%%%% %%% %%%%%%%%%%% % % % %%%%%%%%% %%%%%%%%%%%%%%% %%% %%%%%
%%%%% %%%         %%%%%%%%%%% %   %%%       %                 %       %   % %%%       %%% % %%% %%%%%
%%%%% %%%%% % %%%%%%%%%%%%%%% %%%%%%% %%% %%% %%%%%%%%%%% %%%%% %%%%% % %%% %%% %%%%% %%% % %%% %%%%%
%%%     %%% % %%%%% %%%%% %   %%%     %%% %%% %%%%%   %%% %%%   % %%%   %%%       %%%     % %   %   %
%%% %%% %%% % %%%%% %%%%% % %%%%% %%%%%%%%%%% %%%%%%% %%%%%%%%% % %%% %%%%%%%%%%%%%%%%% %%% % %%% % %
%   %%%     % %%%%% %%%%%   %%% %   %%%           %%% %%%%% %%%   %%% %%%%%%%%%%%%%%%   %%%   %%% % %
%%% %%%%% %%% %%%%% %%%%% %%%%% % % %%% %%%%%%%%%%%%% %%%%% %%%%%%%%% %%%%%%%%%%%%%%% % %%%%%%%%%%% %
%%% %%%%% % %   %%%   %%% %%%%%   % %%%       %%%%%   %         %%%   %%%%%   %%%     %   %%%%% %%% %
%%% %%%%% % %%% %%%%% %%% %%%%%%% % %%%%% %%% %%%%% %%% %%% %%% %%% %%%%%%% %%%%%%%%% %%% %%%%% %%% %
%%% %%%     %   %%%   %   %   %%% %   %%% %%% %%% %     %   %%% %%% %%% %%% %%% %%%%% %   %         %
%%% %%% %%%%% % %%% %%% %%% %%%%%%%%% %%%%%%% %%% % %%%%% %%%%% %%%%%%% %%% %%% %%%%% % %%%%%%% % %%%
%%% %%%   %%% % %%% %   %%%     %       %%%   %%%   %%%%%   %         %     %%%       %     %%% % %%%
%%%%%%%%%%%%% %%%%% % %%%%%%%%% % %%%%%%%%% %%%%%%%%%%%%%%% %%%%% %%% % % %%%%%%%%% %%%%%%% %%% %%%%%
%             %     % %         %   %%%%%%% %   %%%%%%%     %%%%% %%%   % %%%   %   %     %     %%%%%
%%% %%%%% %%%%% %%% % %%% % %%%%%%% %%%%%%% % %%%%%%%%% %%%%%%%%% %%%%%%% %%% % % %%%%%%% %%%%% %%%%%
%%%   %   %%%   % %       % %%%%%%%     %%% % %%% %%%   %%%     % % %%%       %   % %%%%%     % % %%%
%%% % %%% %%% %%% %%%%%%%%%%%%%%%%%%% %%%%% % %%% %%% % %%%%% % % % %%%%%%%%% %%%%% %%%%% %%%%% % %%%
% % % %%% %%%   %     %%%%%%%%% %%%%%     %   %       %   %%% %       %%%%%%% %%%         %%%%% %   %
% % % %%%%%%%%% % % %%%%%%%%%%% %%%%%%%%% %%% % %%%%%%% %%%%% %%%%%%% %%%%%%%%%%%%%%% %%% %%%%% %%% %
%   %         % % % %%% %%%     %       % %   %     % %   %   %%%%%   %     %%%%%%%%%   %   %%%     %
% %%% %%% %%% % % %%%%% %%% %%% % % %%% % % %%% %%% % %%% %%% %%%%% %%% %%% %%%%%%%%%%%%% %%%%% %%%%%
% %%%   % %%% % %       %   %%% % % %%% %   %%% %%%   %   %%% %%%%%     %%% %%%%%%%%%%%%% %%%   %%%%%
%%%%% %%% %%%%% %%% % % % %%%%%%% % %%% %%% %%%%%%%%%%% %%%%% %%%%% %%%%%%%%%%%%%%%%%%%%% %%% %%%%%%%
%%%%% %%%   %%% %%% % % %     %   % %%% %%%   %%% %%%%%     %   %%% %%%%% %%% %%%%%%%     %   %%%   %
%%%%%%%%% %%%%% %%% % % % %%% % %%% %%% %%%%%%%%% %%%%% %%% % %%%%%%%%%%% %%% %%%%%%%%% %%% %%%%% %%%
%%%%%%%%% %%%   % % % % % %%%   %   %     %%%%%   %%%%%   % % %%% %%%           %%%%%   %%% %%%     %
%%%%%%%%% %%%%% % % % % %%%%% %%% %%%%%%% %%%%%%% %%%%%%%%% %%%%% %%%%%%%%%%%%% %%%%% % %%% %%%%% % %
%%%%%   %   %%% %   % % %%%     %   %%%%%     %%%     %%%%%       %   %%%%%%%%% %%%   % %   % %%% % %
%%%%% %%% % %%% %%%%% % %%%%% %%%%% %%%%%%% %%%%% % %%%%%%% % % %%% % %%%%%%%%% %%%%% %%% %%% %%%%% %
%%%       %   % %%%%% % % %%% %%%%% %   %%% %%%   % %%%   % % % %%% % %%%%%%%%%       %%%   %       %
%%%%%%%%%%% % % %%%%% % % %%%%%%%%% % % %%% %%%%%%% %%%%% % % %%%%% % %%%%%%%%% %%% %%%%%%% % %%% %%%
%%%%%%%     % % %     %     %%% %%% % % %   %%%%%%%   %%%   %     % %   %%%%%     %     %%%   %   %%%
%%%%%%% %%%%% % % % % %%%%% %%% %%% % % % %%%%%%%%% %%%%% %%% %%% % %%% %%%%%%%%%%%%% % %%%%% %%%%%%%
%%%     %%%%% % % % % %%%%%   % %%%   % % %%%   %%% %%%   %%% %%%   %   %%%%%%%%%%%%% %       %%%%%%%
%%%%% %%%%%%%%% %%% % %%%%%%% % %%% %%% %%%%%%% %%% %%% %%%%%%%%% %%% %%%%%%%%%%%%%%%%% %%% %%%%%%%%%
%%%   %%%   %%% %%% % %%%%%%%   %%% %%% %%%     %   %%%     %%%   %%% %%%%%%%%%%%%%%%%% %%%   %   %%%
%%% % %%% %%%%% %%% %%%%%%%%% %%%%% %%% %%% %%% % %%%%%%%%% %%%%%%%%% %%%%%%%%%%%%%%%%%%%%%%% % %%%%%
%   % %%%   %%%   % %%% %%%   %%%   % %     % %   %%% %%%%% %     %   %%%%%%%%%%%%%%%%%%% %%% %     %
%%% %%%%% % %%%%% % %%% %%%%% %%% %%% %%% %%% %%% %%% %%%%% % %%% %%% %%%%%%%%%%%%%%%%%%% %%% %%%%% %
%%%   %%% %     %       %%%%% %%%     %%% % %         %%%   % %   %     %%%%%%%%%%%%%%%             %
%%% % %%%%%%%%% %%%%%%% %%%%% %%%%% %%%%% % % %%%%%%% %%%%%%% %%% % %%%%%%%%%%%%%%%%%%% %%%%%%% %%% %
%%% %   %%%%%%%     %%%   %%%     % %%%   %   %%% %     %%%%% %%% % %%%%%%%%%%%%%%%%%%%   %%%%% %%% %
%%% %%% %%%%%%% %%% %%%%% %%%%%%% %%%%% %%% %%%%% % %%% %%%%% %%% % %%%%%%%%%%%%%%%%%%%%% %%%%%%%%% %
%     %           %         %%%         %     %%%   %%%       %%%     %%%%%%%%%%%%%%%%%%%     %%%   %
%%%%%%%%%%%%%%%%%%%%%%%%%%%%%%%%%%%%%%%%%%%%%%%%%%%%%%%%%%%%%%%%%%%%%%%%%%%%%%%%%%%%%%%%%%%%%%%%%%%%%
