%%%%%%%%%%%%%%%%%%%%%%%%%%%%%%%%%%%%%%%%%%%%%%%%%%%%%%%%%%%%%%%%%%%%%%%%%%%%%%%%%%%%%%%%%%%%%%%%%%%%%
%           %%%         %%%%% %%%%%%%%%       %%%%% %%% %%%%%         % %%% %%%       %%%   %%%   %%%
% % %%% %%%%%%%%% %%%%%%%%%%% %%%%%%%%%%% %%% %%%%% %%% %%%%% %%% %%% % %%% %%% %%%%% %%% %%%%% % %%%
% % %   %%%%% %%% %%%%%%%     %%%%%%%%%%% %%%       %     %   %   %%%   %%% %   %%%%%     %%%   %   %
% % %%% %%%%% %%% %%%%%%% %%%%%%%%%%%%%%% %%%%% %%% % %%% % %%% %%%%%%%%%%% % % %%%%%%% %%%%% %%%%%%%
% % %%% %         %%%     %%%%%%%%%%%%%%%   %%% %%% % % %   %%%   %       %   %   %   % %%%   %%%%%%%
% % %%%%% %%%%%%% %%%%% %%%%%%%%%%%%%%%%%%% %%% %%%%% % %%%%%%%%% % %%%%% % %%%%% %%% % %%% % %%%%%%%
% %   %%% % %%%%%       %%%     %%%%%   %%% %%%   %%%   %     %%% % % %%%   %%%%%   %       %     %%%
%%% % %%% % %%%%%%% %%%%%%%%%%% %%%%% %%%%% %%%%%%%%%%% % %%% %%% % % %%%%% %%%%%%% %%%%% %%%%% %%%%%
%%% %   %   %%%%%%% %         %   %%%   %     %%%%%%%%%   %%% %%% %   % %%%     %   %%%   %%%   %%%%%
%%% %%% % %%%%%%%%% % %%% %%% % %%%%% % % %%% %%%%%%%%%%% %%%%%%% %%% % %%% %%%%% %%%%% %%%%%%%%%%%%%
%     %   %%%     %   %   %     %%%%% %   %%% %%%   %%% % % %%%         %%% %     % %%% %%% %%%%%%% %
%%%%% %%%%%%%%%%% %%%%% %%%%%%%%%%%%%%% %%%%% %%% %%%%% % % %%% %%% %%%%%%%%% %%%%% %%% %%% %%%%%%% %
%%%%%             %%% % %%%         %%%   %%%     %%%   %   %%% %%% %       % %%%%%         %%%     %
%%%%%%%%%%%%%%%%% %%% % %%% %%% %%% %%%%% %%% % % %%% %%%%% %%%%%%%%% %%%%% % %%%%% %%% %%%%%%% %%% %
%                 %   %     %%% %%% %%%%% %%% % % %           %%%%%%% %       %%%   %%% %%%%%   %%% %
% %%% %%%%% %%%%% %%% %%% %%%%% %%% %%%%% %%%%% %%% %%% %%%%%%%%%%%%% % %%%%%%%%% %%%%%%%%%%% %%%%%%%
% %%% %%%%% %%%%% %%% %%%   %%% %%%     %   %%%     %%% %%%     %     % %%%%%%%       %%%     %%%%%%%
%%%%%%%%%%% %%%%% %%% %%%%%%%%% %%%%% %%%%% %%%%%%%%%%%%%%% %%% % % %%%%%%%%%%% %%%%%%%%% %%%%%%%%%%%
%%% %%%     %%% % %     %%%%% %   %   %%%   %%%%% %%% %%%   % %   % %%%%%%%%%%% %%%%%%%   %%%%%%%%%%%
%%% %%%%% %%%%% % % % % %%%%% % %%% %%%%%%% %%%%% %%% %%% %%% %%%%% %%%%%%%%%%%%%%%%%%% % %%%%%%%%%%%
%   %%%%% %%%   % % % %   %%%   %%% %%% %%%   %   %%%     %         %%%  S    %%%       %   %%%%%%%%%
%%% %%%%%%%%% %%% %%% % %%%%% %%%%% %%% %%%%% % %%%%% %%% %%%%% %%% %%%%%%%%% %%%%% % % %%%%%%%%%%%%%
%%%     %%%   %%%     % %%%   %           %%%   %%%   %%% %%%%% %%%   %%%%% %   %%% % % %%%%%%% %%% %
%%%%%%% %%%%% %%% %%%%%%%%%%% % %%%%%%% %%%%% %%%%% %%%%%%%%%%%%%%% %%%%%%% % %%%%%%% %%%%%%%%% %%% %
%       % %%% %%% %%%%%%%%%%% %     %   %%%%% %%%%%           %%%%% %%%       %%% %%% %%%       %%% %
% %%%%% % %%% %%% %%%%%%%%%%%%%%%%% %%%%%%%%% %%%%%%% %%%%% % %%%%% %%% %%%%% %%% %%% %%% %%%%% %%% %
%   %%% %     %   %%%%%%%%%         %%%%% %%% %%%%%%%   %%% %   %%% %%%   %%%   %     %%% %%%%%   % %
%%% %%% % %%%%% %%%%%%%%%%%%% % %%%%%%%%% %%% %%%%%%%%% %%% %%%%%%%%%%%%% %%%%% %%%%% %%% %%%%%%% % %
%%% %     %%%       %%%       % %%%%%   %           %%% %%% %     %%% %%% %%%%%           %         %
%%% %%%%% %%% %%% %%%%% %%%%%%% %%%%% %%% %%%%%%%%% %%%%%%% % %%% %%% %%%%%%%%%%%%%%% %%%%%%%%% %%% %
%   %%%   %%% %%% %%%     %     %%%   %%% %%%%%%%%% % %%%     %%%       %%%   %%%%%%% %%%%%%%%% %%% %
% %%%%% %%%%% %%%%%%%%%%% % %%%%%%% % %%% %%%%%%%%% % %%% %%% %%% %%%%% %%%%% %%%%%%% %%%%%%%%%%%%% %
% %%%%% %%%%% %%%%%%%%%   %   %     %     %%% %%%%%   %%% %%%   % %%%     %%%   %%%       %%%%%%%%% %
% %%%%%%%%%%% %%%%%%%%% %%%%%%% %%% %%%%%%%%% %%%%%%%%%%%%%%%%%%% %%%%% %%%%%%% %%% %%% %%%%%%%%%%%%%
% %%%%%     %         %         %%%       %             %%%%%%%%%   %%% %%%     %%% %%% %%%%%   %%%%%
% %%%%% %%% % %%%%%%% %%% %%%%% %%%%%%% %%% %%% %%%%%%% %%%%%%%%%%% %%% %%% %%%%%%%%%%% %%%%% % %%%%%
%   %%%   %   %%%%%%% %%%   %%% %%%     %%% %%% %%%   %   %%%   %   %%%     %%%%% %%% % % %%% % %%% %
% % %%%%% %%%%%%%%%%%%%%% %%%%% %%%%%%%%%%% %%%%%%% %%% %%%%% % % % %%%%%%% %%%%% %%% % % %%%%% %%% %
% %       %     %%%%%   % %   % %   %       % %%%   %%% %%%   % % %   %%%%% %%%       % % %%%       %
% %%%%%%% % %%% %%%%% % %%% % %%% % % % %%%%% %%% %%%%% %%% %%% % %%% %%%%%%%%% % %%%%% % %%% %%%%% %
%   %%%%% % %%%       %   % %     %   % %%%       %%% % %   %%%   %%%   % %%%   % %%%%% % %%% %%%   %
% %%%%%%% % %%% %%%%%%%%% % %%%%%%%%%%%%%%% %%% %%%%% % %%% %%%%%%%%%%% % %%%%% %%%%%%% % %%% %%%%% %
% %%%%%%% % %%% %%%%%       %%% %%%   %%% % %%%         %%%     %%%%% %         %%%   %       % %%% %
%%%%%%%%%%% %%%%%%%%%%% %%%%%%% %%%%% %%% % %%%%%%%%%%%%%%%%%%% %%%%% %%%%%%% %%%%% %%% %%%%%%% %%% %
%%% %%% %%%   %%%%%%%%% %%%     %%%%%           %   %%%           %%%         %%%%% %   %%%%%%%   % %
%%% %%% %%%%% %%%%%%%%%%%%% %%% %%%%% %%%%%%%%% %%% %%%%% %%%%%%% %%%%%%%%% %%%%%%% % %%%%%%%%%%% % %
%   %%%         %%%%%%%%%   %%%   %%%   %%%%%       %     %%%%%%%   %%%%%%%   %%%   %   %     %%% % %
% % %%%%%%% %%%%%%%%%%%%%%% %%% %%%%%%% %%%%%%%%%%% %%% %%%%%%%%%%% %%%%%%%%%%%%% %%%%% % %%% %%% % %
% %         %           %%% %%% %%%%%%%   %%%%%%%%%     %     %       %%%%%%%     %%%%% % %   %%%   %
% % %%%%%%% % %%%%% % %%%%%%%%% %%%%%%% %%%%%%%%%%%%%%%%% % %%% %%%%% %%%%%%% % %%%%%%% % %%%%%%%%% %
% % %%%     % %%%   % %%%%%%%%%     %   %%%       %%%%%   %     %%%%%       % % %%% %%% %       %%% %
% %%%%% %%%%% %%% %%% %%%%%%%%% % %%% %%%%% % %%% %%%%%%% %%%%% %%%%%%% %%%%% % %%% %%% %%%%% % %%%%%
% %%%%% %       % %   %%%%%     %     %     % %%%     %%%   %%% %%%   % %%%   %     %%% %%%   %   %%%
% %%%%% % %%%%%%% %%%%%%%%%%%%%%% %%%%%%% %%% %%% %%%%%%%%% %%%%%%%%% % %%% %%% %%% %%% %%% %%%%% %%%
%   %   % %   %%%               %     %%% %%% %%% %%%%%%%   %%%%% %%% %   % %%% %%%         %%%   %%%
%%% %%%%% %%% %%%%%%%%%%%%%%%%% %%% %%%%%%%%% %%%%%%%%%%%%% %%%%% %%% %%% % %%%%%%% %%% %%%%%%%%%%%%%
%%% %       % %%%%%       %%%%% %   %%%       % %%%%%%%%%%%   %%%         %   %%%   %%% %%%%%%%%%%%%%
%%% % %%%%% % %%%%% %%%%% %%%%% %%% %%% % %%% % %%%%%%%%%%%%% %%%%%%%%%%%%%%% %%%%% %%%%%%%%%%%%%%%%%
%   %   %%%   %%%%%   %   %%%%% %%%     % %%%       %%%%%%%   %   %%%   %     %%%%%   %%%%%%%%%%%%%%%
% %%%%% %%%%%%%%%%%%% % %%%%%%% %%%%%%%%% %%%%% %%% %%%%%%%%%%% % %%% % % %%%%%%%%%%% %%%%%%%%%%%%%%%
%         %%%%%%%%%%% % %%%         %%%     %%% %%%   %%% %%%%% %     %   %%%     %%% %%%%%%%%%%%%%%%
%%% %%%%% %%%%%%%%%%% % %%%%%%%%%%% %%%%%%% %%%%%%% %%%%% %%%%% %%%%%%%%%%%%% % %%%%% %%%%%%%%%%%%%%%
%%% %%%%% %   %%%%%   %   %%%%%   %     %     %%%%% %%%         %%%     %%%   % %%%   %%%%%%%%%%%%%%%
%%%%%%%%% % %%%%%%%%%%% % %%%%%%% %%% % %%%%% %%%%%%%%%%%%% %%% %%% %%% %%% % %%%%% %%%%%%%%%%%%%%%%%
%%%%%     % %%%         % %%%     %%% % %%%%% %%%%%%%%%%%%% %%%     %%%   % % %%%   %     %%%%%%%%%%%
%%%%% %%%%% %%% %%%%%%%%% %%% %%% %%% % %%%%% %%%%%%%%%%%%%%%%% %%%%%%%%% % %%%%% %%% %%% %%%%%%%%%%%
%%%             %%%%%%%%% %%%   % %%% % %       %%%       %%%%% %%%%% %%% % %%% % %%% %   %%%%%%%%%%%
%%% %%%%% %%%%%%%%%%%%%%%%%%%%% % %%% % % %%%%% %%% % %%%%%%%%%%%%%%% %%% % %%% % %%%%% % %%%%%%%%%%%
%%% %%%%% %%%%%%%   %%%%%%% %%% % %%% % % %%%%% %   % %       %%%           %%%         %   %%%%%%%%%
%%%%%%%%% %%%%%%% %%%%%%%%% %%% % %%%%% % %%%%% % % %%% %%%%% %%% %%%%%%%%%%%%%%%%%%% %%%%% %%%%%%%%%
%%%%%       %   %   %%%         % %%%%% % %%%   % % %%% %   %     %%%     %%% %%%%%%% %%%   %%% %%%%%
%%%%%%% %%% %%% % % %%% %%%%%%% %%%%%%% %%%%%%% % % %%% % %%%%% %%%%% %%% %%% %%%%%%%%%%% %%%%% %%%%%
%   %%% %%% %%%   % %%% %   %%%     %%% %     %   % %%% % %%%%% %%%   %%%       % %%%%%       % %%% %
% % %%%%%%% %%%%%%% %%% %%% %%% % %%%%% % %%% %%%%%%%%% % %%%%%%%%% %%%%%%% %%% % %%%%%%%%%%% % %%% %
% %   %%% % %%%       % %   %%% %     %   %%% %%%%%%%%% %   %%%%%   %%% %%% %%%   %   %%%%%%% %     %
% % %%%%% % %%% %%%%%%% % %%%%% %%%%% %%% %%% %%%%%%%%% %%% %%%%% %%%%% %%%%%%%%% %%% %%%%%%% %%%%% %
% %   %     %             %%%   %%%%% %%% %%%       %   %   %%%   %%%%%     %%%%%     %%%       %%% %
% %%% % %%%%% %%%%%%% %%%%%%%%% %%%%% %%%%%%%%% %%% % %%% %%%%%%% %%%%% %%% %%%%%%% %%%%%%%%%%% %%% %
% %   % %%%%% %%%%%%% %%%%%%%%%   %%%   %%%%%%%   %   %   %%% %%% %     %   %   %%% %%%%%%%%%%%     %
%%% %%% %%%%%%%%%%%%% %%%%%%%%%%%%%%% %%%%%%%%%%%%%%% %%% %%% %%% % %%%%% %%% %%%%% %%%%%%%%%%%%%%% %
%%%         %%%%%%%   %%%             %%%     %%%%%%% %%% %%% %%%   %%%   %%% %%%   %%%%%           %
%%%%% %%%%% %%%%%%%%%%%%% %%%%%%%%%%% %%%%% %%%%%%%%% %%% %%% %%% %%%%% %%%%% %%% %%%%%%%%%%% %%%%% %
%%%%%   %%% %%%%%         %%%         %     %%% %%% %       % %%% %     %%%     %   %   %%%%% %%%%% %
%%%%%%%%%%% %%%%% %%%%%%%%%%% %%%%% %%%%% %%%%% %%% %%%%%%% % %%%%% %%%%%%%%%%% %%% % %%%%%%% %%%%%%%
%%%%%%%%%   % %%% %     %%%     %%%       %%%%%         %%%   %%%%% %%%   %%%     %   %%%     %   %%%
%%%%%%%%% %%% %%% %%%%% %%% %%% %%%%%%% %%%%%%% %%%%% %%%%%%% %%%%% %%%%% %%% %%%%%%% %%% %%%%%%% %%%
%%%%%%%%% %   %%%   %%%     %%%   %%%   %%%%%       % %%% %%%       %     %%%         %%% %%% %%%   %
%%%%%%%%% %%% %%%%% %%%%%%%%%%%%% %%%%% %%%%% %%%%% %%%%% %%%%%%%%%%% %%% %%% %%%%%%%%%%% %%% %%%%% %
%%%%%%%             %%%%%%%%%%%%% %%%%% %%%%%     %       % %%% %%%%%   %   %     %%% %%%       %   %
%%%%%%%%%%%%%%%%%%%%%%%%%%%%%%%%% %%%%%%%%%%%%%%%%%%% %%% % %%% %%%%% % % %%%%%%% %%% %%% %%%%% % %%%
%%%%% %%%     %%%     %%%%% %%%%% %%%%%%%   %%%%%%%   %     %         % % %%%     %   %%% %%%%%   %%%
%%%%% %%% % %%%%% %%% %%%%% %%%%% %%%%%%%%% %%%%%%% % %%%%% % %%%%%%%%% %%%%% %%%%%%% %%% %%%%%%%%%%%
%%%     % %       %%% %%%%%     %         % %%%%%%% % %%%   %     % %%%     %         %%% %%%%%%%%%%%
%%%%% %%% %%% %%% %%%%%%%%% %%%%%%%%%%%%% % %%%%%%% %%%%%%%%%%%%% % %%%%%%% %%%%%%% %%%%% %%%%%%%%%%%
%     %%% %   %%%   %%%   %     %%%%%%%%% % %%%%%%% %%%   %     % %       %     %%% %%%   %%%%%%%%%%%
% %%%%%%% % % %%% %%%%% % % %%% %%%%%%%%% % %%%%%%% %%% % % %%% % %%% %%%%%%% %%%%% %%%%% %%%%%%%%%%%
%         % % %%% %%% % %   %%%     %%%%% %   %%%     % % % %%%       %%%%%%% %%% %!% %%%   %%% %%%%%
%%% %%%%%%% %%%%%%%%% % %%% %%%%%%% %%%%% % % %%%%%%% % % % %%% %%%%% %%%%%%% %%% % % %%%%% %%% %%%%%
%%%   %%%%%             %%% %%%%%%%         % %%%%%%%   %   %%% %%%         %         %%%       %%%%%
%%%%%%%%%%%%%%%%%%%%%%%%%%%%%%%%%%%%%%%%%%%%%%%%%%%%%%%%%%%%%%%%%%%%%%%%%%%%%%%%%%%%%%%%%%%%%%%%%%%%%
