%%%%%%%%%%%%%%%%%%%%%%%%%%%%%%%%%%%%%%%%%%%%%%%%%%%%%%%%%%%%%%%%%%%%%%%%%%%%%%%%%%%%%%%%%%%%%%%%%%%%%
%%%%%%%           %%%     %%%%%     %%% %%%   %%%%%   %%% %         %%%%%%%%%%%%%%%%%         %   %%%
%%%%%%%%%%%%%%% %%%%%%% %%%%%%%%% %%%%% %%%%% %%%%%%% %%% % % %%% %%%%%%%%%%%%%%%%%%% % %%%%% % %%%%%
%           %%%     %%% %%%   %%% %%%     %%% %%%%%%% %     % %%% %%% %%% %%%%%   %%% % %%%%% %     %
% %%%%% %%% %%%%%%% %%% %%%%% %%% %%%%% %%%%% %%%%%%% % %%%%% %%% %%% %%% %%%%%%% %%%%% %%%%% %%% %%%
%   %   %%% %       %%%     %       %%%       %%%%%   %   %%%   % %%%             %%%   %     %%% %%%
%%% % %%%%% % %%% %%%%% %%% %%%%% %%%%%%%%% % %%%%% %%%%% %%%%% %%%%% %%% %%% %%%%%%% %%% %%%%%%% %%%
%   % %%%     %%% %%%   %%% %   % %%%       %       %%% % % %%%       %%% %%%         %%% %%%     %%%
%%% % %%%%%%%%%%%%%%%%% %%% % % % %%% % %%% %%%%%%% %%% % % %%%%%%%%% %%%%%%%%% %%% %%%%% %%%%% % %%%
%%% % %       %         % % % %   %%% % %%% %%%%%%%     %       %%%%%   %%% %%%   % %%% % % %%% % %%%
%%% % % %%%%% % %%%%% %%% % % %%% %%% %%%%%%%%%%%%% %%%%%%% %%%%%%%%%%% %%% %%%%%%% %%% % % %%%%% %%%
%%% %       %   %%% %   %     %   %%%     %%% %%%%% %%%     %%%%% %%%   %%%   %%%   %%%     % %%%   %
%%% %%% %%% %%% %%% %%% %%%%% %%% %%%%% %%%%% %%%%%%%%% %%%%%%%%% %%% %%%%%%% %%% %%%%% %%% % %%%%% %
%   %%% %%% %%% %%% %%% %%%   %%%       %%%     % %%% % %%%%%         %%%%%   %   %%% % %%%     %%% %
% %%%%%%%%%%%%% %%% %%% %%%%%%%%%%% %%% %%% %%% % %%% % %%%%% %%%%% %%%%%%% %%% %%%%% % %%% %%% %%% %
% %%%%%%% %%%%% %%% %%%         %%% %%%     %%%     %   % %%%   %%% %%%%%   %%% %%%%%   %%% %%%     %
% %%%%%%% %%%%% %%% %%%%%%%%%%% %%%%%%%%%%%%%%%%% %%% %%% %%%%%%%%% %%%%% % %%% %%%%%%% %%% %%% %%% %
% % %%%   %%%       %%% %%%%% %   %%%%%%%%%       %%%       %%%%%%%       %   %     %%% %%% %%% %%% %
% % %%%%% %%% %%%%%%%%% %%%%% % % %%%%%%%%% %%% %%%%%%%%% %%%%%%%%%%%%% %%%%%%%%% %%%%% %%%%%%% %%% %
% %   %%% %%% %%%%%%%         % % %   %%%   %%%   %       %%%%%%%%%     %         %%%%% %%%%%   %%% %
% %%% %%% %%%%%%%%%%%%% %%%%%%% %%% % %%%%%%%%%%%%% %%%%%%%%%%%%%%% %%%%% %%%%% %%%%%%% %%%%%%%%%%%%%
%     %%%   %%%     %%% %%%%%%%     %   %%%%%         % %%%%%%%%%   %%%%% %%%   %%% %%%   %%%%%%%%%%%
%%%%% %%% %%%%% % %%%%% %%%%%%%%%%%%% %%%%%%% %%%%%%% % %%%%%%%%%%% %%%%% %%%%%%%%% %%%%% %%%%%%%%%%%
% %   %%% %%%%% %       %%%   %%%   % %       %   %%%   %%% %%%%%%% %%%%%   %%%%%%%               %%%
% % %%%%% %%%%% %%%%%%% %%%%% %%%%% % % %%% %%%%% %%%%% %%% %%%%%%% %%%%%%% %%%%%%%%% %%%%%%% %%% %%%
% % % %%%   %%%     %%% %%%%%   %   %   %%%       %%%     %   %%%   %%%%%%% %     %%% %%%%%   %%% % %
% % % %%% % %%% %%%%%%% %%%%% % % % %%%%%%%%%%%%% %%% %%%%% % %%%%%%%%%%%%% % %%%%%%%%%%%%% %%%%% % %
%   %     % %   %%%%%     %%% %   % %%%   %%%     %%% %%%%% % %%%%%   %%%   %   %%% %%%     %%%     %
% %%%%% %%%%% %%%%%%% %%% %%% %%% %%%%%%% %%%%%%% %%%%%%%%% % %%%%% % %%%%% %%% %%% %%%%%%%%%%% %%%%%
% % %%%     % %     % %       %%% %%%%%%%   %%%%%   %%% %%% % %     %       %   %%%   %%%%%%%%% %%%%%
% % %%% %%% % % %%% % % %%%%% %%%%%%%%%%% %%%%%%%%%%%%% %%% % %%% %%%%% %%%%% %%%%% %%%%%%%%%%% %%%%%
% % %%%   %     %%% % % %%% %   %%%%%%%%% %%% %%%%%%%   %%% %     %%%   %%%%%   %%% %%%   %%%   %%%%%
% % %%%%%%% %%%%%%%%% %%%%% %%% %%%%%%%%% %%% %%%%%%% %%%%% %%%%% %%%%%%%%%%% % %%% %%% % %%%%% %%%%%
%   %%%%%%% %%%%% %%% %%%%% %%% % %%%         %       %%%   %%%   %%%%%%%     % %%% %%% %   %%%   % %
%%% %%%%%%% %%%%% %%% %%%%% %%% % %%% %%% %%% % % %%%%%%% % %%%%%%%%%%%%% %%%%% %%% %%%%% %%%%%%% % %
%%%   %%%     %%%     %%%%%       %%% %%% %%% %!% %%%%%   % %%%%%%%%% %%% %%%%%           %%% %%%   %
%%%%% %%% %%% %%% %%% %%%%%%% %%%%%%%%%%% %%% %%% %%%%%%%%% %%%%%%%%% %%%%%%%%% %%% %%%%% %%% %%%%% %
%%%   %%% %%% %%%   %   %%%%% %%%%%%%%%   %%%   %     %   % %%%         %%%%%     %   %%% %   %%%%% %
%%% %%%%%%%%% %%% % %%% %%%%%%%%%%%%%%% %%%%%%% % %%%%% % % %%%%%%%%% % %%%%%%%%% %%% %%%%% % %%%%% %
%   %   %%%%% %%% % %%%     %%% %%%   % %%% %%%   %     %     %%%     % %%% %%%%% %%%     % %   %   %
%%% % %%%%%%% %%%%% %%%%%%% %%% %%% % % %%% %%% %%% %%%%% %%%%%%% %%%%%%%%% %%%%% %%%%%%% % % %%% %%%
%%% % %%%%%   %%%     %%%   %%% %%% %   %%%   % %   %     %%%%%   %     %   %%% %   %%% %   % %%%   %
%%% % %%%%%%%%%%% %%%%%%% %%%%% %%% %%%%%%% % % % %%% %%%%%%%%% % % %%% % % %%% % %%%%% %%%%% %%%%% %
% % %     %%%%%         % %%%%%     %%%%% % %   %   % %%%   %%% % % %%%S% % %%%   %%%       % %%%%% %
% % %%% % %%%%%%% %%%%% %%%%%%% %%% %%%%% % %%%%% % % %%% %%%%% % % %%%%% % %%% %%%%% %%% % % %%%%% %
%   %%% %   % %%%   %%%     %%% %%% %%%%%   %%%%% % %     %%%   % %   %%% % %%% %%%   %%% % % %     %
% %%%%%%% % % %%%%%%%%%%% %%%%% %%%%%%%%%%% %%%%% % %%%%% %%% %%%%%%% %%% %%%%% %%% %%%%% %%% % %%%%%
% %%%     %     %%%%%     %%%     %%%   %%%   %%% % %%%%% %%%     %%%     %%%   %   %%%   %%% % %%% %
% %%% %%%%% %%%%%%%%% %%% %%%%%%% %%%%% %%%%%%%%%%% %%%%% %%%%%%% %%% %%%%%%% %%% %%%%%%% %%% % %%% %
%     % %%% %%%%% %%% %%% %%%%%%%   %%%   %     %%% %%% %   %     %   %%%%%%% %%% %%%     %   %     %
%%%%%%% %%% %%%%% %%% %%% %%%%%%% %%%%% % % %%% %%% %%% %%% % %%% % %%%%%%%%% %%%%%%% %%% % % %%%%% %
%%%%%%%   % %     %   % % %       %%% % %   %%% %   %   %%%   %   % %     %   %   %   %%% % % %%%%% %
%%%%%%%%% % % %%% %%% % % % %%%%% %%% % %%%%%%% % %%% %%%%%%%%% %%% % %%% %%% % % %%% %%% % %%%%%%% %
%%%%%     %   % %     %     %%%     % % %%%%%     % %     %%%   %%% % %%%   %   %     %   % %%%%%   %
%%%%% % %%%%%%% %%%%%%% %%%%%%%%%%% % % %%%%% %%%%% % %%% %%% %%%%% % %%%%% %%% %%%%%%% %%% %%%%% %%%
%%%   % %%% %%% %%%%%%%   %%%%%%%%%   % %     %%%%%   %%% %%% %%% %   %     %%% %%%%%   %%% %%% % %%%
%%%%% %%%%% %%% %%%%%%% %%%%%%%%%%%%%%% %%% %%%%%%% %%%%% %%% %%% %%%%% %%% %%%%%%%%%%% %%% %%% % %%%
%   % %%%             % %%%     %     % %%% %%%%%%% %%%       %%% %%%%% %%%   %%%   %%% %%% %%%     %
% % % %%%%%%% %%%%% % % %%%%% % % %%% % %%% %%%%%%% %%%%%%%%% %%% %%%%%%%%%%% %%% %%%%%%%%% %%% %%%%%
% %     %%%%% %%%%% %   %     % % %%%   %     %%%%% %%%%%%%%% %%%     %%%         %%%%%%%       % %%%
% %%%%% %%%%% %%%%%%%%%%% % %%% % %%% %%% %%%%%%%%% %%%%%%%%%%%%% %%%%%%% %%%%%%% %%%%%%%%% %%%%% %%%
% %%%%% %     %   %%%%%%% % %   % %   %%%   %%%             %%%   %%%%%   %%%%%%% % %%% %%%   %   %%%
% %%%%%%% %%%%% % %%%%%%% % %%% % % %%%%%%%%%%%%%%%%%%%%%%% %%% % %%%%%%%%%%%%%%% % %%% %%%%% % % %%%
%   %%%%% %%%   %     %%% %   % % % %%%   %           %%%%%     %     %%%%%   %   %       %%%   % % %
% %%%%%%% %%%%% %%%%% %%%%%%% % % %%%%% % % %%% %%%%% %%%%% %%% %%% %%%%%%% %%% %%%%%%% %%%%%%%%% % %
%     %%% %%%%%   %       %%% % % %%%   %   %%%   %%%   %   %%% %%% %%%%%%%   %   %%%%% %%% %   %   %
%%%%% %%% %%%%% %%% % %%% %%% %%% %%% %%%%%%%%%%% %%%%% % %%%%% %%%%%%%%%%%%% %%% %%%%% %%% % % % %%%
%%%     %   %%% %%% % %%%     %%%       %     %%% %%%%% % %%%   %%%%%     %%%   %   %%%     % %   %%%
%%% %%% %%% %%% %%% %%%%%%%%% %%%%% %%%%% %%% %%%%%%%%% % %%%%%%%%%%% %%%%%%% %%%%% %%% %%% % %%%%%%%
%   %     %   % %%%   %%%       %%% %%%   % %       %   % %%%%%%%       %%%%%       %   %%%         %
% % %%%%%%%%% %%%%% % %%%%% %%% %%% %%% %%% % %%%%% % %%% %%%%%%% %%%%% %%%%% %%%%%%% %%%%%%% %%%%%%%
% %   %   %%%     % %   %%% %%% %%%   % %     %%%%%   %%% %%%     %   %   %%% % %%%   %%%%%%% %%%%%%%
% %%% % % %%%%%%% %%% % %%%%%%%%%%%%%%% %%% %%%%%%%%%%%%% %%% %%%%% % %%% %%% % %%%%%%%%%%%%%%%%%%%%%
%   %   %     %%% %%% %   %%%%%%% %%%   %%%       %%%%%%%   %   %   % %%%     %   %%%%%%%%%%%%%     %
%%% %%%%%%% %%%%% %%%%% %%%%%%%%% %%% %%%%%%% %%%%%%%%%%%%% %%% %%%%% %%%%%%%%% % %%%%%%%%%%%%%%% %%%
%   %   %%% %%% % %     %%%%%%%%%         %   %%%%%%%%%%%   %   %           %%% %       %%%%%     %%%
% %%% % %%% %%% % % %%% %%%%%%%%%%% %%%%% % %%%%%%%%%%%%%%%%% %%% %%% %%%%% %%%%% % %%%%%%%%% %%%%%%%
%     %   %     %   %%%   %%%%%%%%% %%%%% %   %%%       %%%%%     %   %%%%%       % %%%%%           %
%%% %%% %%% % %%%%%%%%%%% %%%%%%%%%%%%%%% % %%%%% %%%%% %%%%%%% %%%%%%%%%%%%%%%%%%% %%%%%%%%% %%% %%%
%%% %%% %%% %         %%%     %%%   %     % %%%     %%% %%%     %%%%%%%         %%% %   %%%%%   %   %
%%% %%%%%%%%% %%%%%%% %%% %%%%%%% % %%%%% % %%%%%%% %%% %%% %%%%%%%%%%%%%%%%%%% %%% % % %%%%% %%%%% %
%%%   %%%%%%% %%% %%%     %       %       % %%%%%%% %%%       %%%     %%%   %%% %%%   % % %%% %%%   %
%%%%% %%%%%%% %%% %%%%%%%%% %%% %%%%%%% %%% %%%%%%%%%%% %%%%%%%%% %%%%%%% % %%% %%%%%%% % %%%%%%% % %
%%%%% %%% %   %   %%% %%%%% %   %%%     %%%     % %%% %   %%%%%           %   %   % %%%   %%%%%   % %
%%%%%%%%% % %%%%% %%% %%%%% %%%%%%% %%%%%%%%%%% % %%% % %%%%%%%%% %%% %%%%%%% % % % %%%%% %%%%% %%% %
%%%%%%%   % %       %   % %   %%%%%   %%% %%%         % %%%   %%% %%%   %%%%% % %   %%%   %%%%% %%% %
%%%%%%% % % % %%%%% % % % %%% %%%%%%%%%%% %%%%%%%%% %%% %%% % %%%%%%% % %%%%% % %%% %%%%% %%%%% %%%%%
%%%%%%% % %   % %%% % %     %       %%%     %%%%%   %%%   % %   %%% % %   %%%   % % % %%%         %%%
%%%%%%% % %%%%% %%% % %%% %%% %%%%% %%% %%%%%%%%%%% %%%%% %%% %%%%% % %%% %%%%%%% % % %%%%% %%%%% %%%
%%%%%%% % %       %   %%% %%%   %%% %             %   %     % %%%       %   %%%%% %     %%% %%% %   %
%%%%%%%%% % %%% %%%%% %%% %%%%% %%% % %%%%% %%%%% %%%%% %%% % %%% %%%%%%% %%%%%%% % %%%%%%% %%% %%% %
%%%%%%%%%     % %     %%% %%%%%   %   %%%%% %%% % %%%%% %%%   %%%   %%%%% %%%     % %%%   % %%%     %
%%%%%%%%% %%%%% % %%%%%%%%%%%%% %%% %%%%%%% %%% % %%%%% %%%%%%%%%%%%%%%%% %%% %%% % %%% % % %%%%%%% %
%%%%%%%%% %%%   %   %%%%%%%   % %%%   %%%       %   %     %%%%%%%%%%%%%%% %%% %%%   %   %   %%%%%%% %
%%%%%%%%%%%%% % %%% %%%%%%%%% % %%%%% %%%%%%% %%%%% % %%%%%%%%%%%%%%%%%%% %%%%%%% %%% %%%%%%%%%%%%% %
%%%%%%%%%%%   % %%% %%%%% %%%   %%%     %%%%% %%%   %   %%%%%%%   %%%     %%%   % %   %%%%%%% %%%   %
%%%%%%%%%%%%% %%%%% %%%%% %%% %%%%%%%%%%%%%%%%%%% %%%%% %%%%%%% % %%%%%%% %%% % %%% %%%%%%%%% %%% %%%
%%%%%%%%%%%%%         %%%     %%%%%%%%%%%%%%%%%   %%%%%   %%%   %   %%%%%     %           %%%   %   %
%%%%%%%%%%%%%%% %%%%% %%% %%% %%%%%%%%%%%%%%%%%%% %%%%%%% %%%%% %%%%%%%%%%%%% %%%%%%% %%% %%%%% %%% %
%%%%%%%%%%%%%%% %%%%% %%% %%% %%%%%%%%%%%%%%%%%%%               %%%%%%%%%%%%%     %%% %%%   %%%     %
%%%%%%%%%%%%%%%%%%%%%%%%%%%%%%%%%%%%%%%%%%%%%%%%%%%%%%%%%%%%%%%%%%%%%%%%%%%%%%%%%%%%%%%%%%%%%%%%%%%%%
