%%%%%%%%%%%%%%%%%%%%%%%%%%%%%%%%%%%%%%%%%%%%%%%%%%%%%%%%%%%%%%%%%%%%%%%%%%%%%%%%%%%%%%%%%%%%%%%%%%%%%
%%%%%%%   %%%       %     %%%     % %%%     %         %   %%%%% %%%       %     %%%     %       %%%%%
%%%%%%% % %%%%% %%% %%% % %%% %%% % %%% %%%%% %%% %%% % % %%%%% %%%%% %%%%% %%% %%% %%% % % %%% %%%%%
%%%     %   %%% %   %%% %   % %     %%%       %   %%% % %   %%%     %   %%% %%%     %%%   % %%% %%%%%
%%% %%%%%%%%%%% %%% %%% %%% % %%%%%%%%%%% %%%%% % %%%%% %%% %%% %%% %%% %%% %%%%%%%%%%%%%%%%%%% %%%%%
%   %%%%%%%%%     %     %%%   %%%%%%% %%% %%%   %   %%% % % %%% %%% %%% %S  %   %%%   %%% %%% % %%% %
% % %%%%%%%%%%%%% %%%%%%%%%%%%%%%%%%% %%%%%%% %%%%%%%%% % % %%% %%% %%% %%%%% %%%%%%% %%% %%% % %%% %
% % %%%%%%%       %%%%%%% %%%%%%%%%   %%%%%             % %     %%% %%%     %   %         %%% % %%% %
% %%%%%%%%% % %%% %%%%%%% %%%%%%%%%%% %%%%%%%%% %%%%%%%%% %%% %%%%% %%%%% %%% % % % %%%%%%%%% % %%% %
% %%%%%%%   % %   %%%%%       %%%       %%%%%%%   %%%%%     % %%% % %%%%%     %   %   %%%%% %   %%% %
% %%%%%%%%%%% %%%%%%%%% % %%%%%%%%% %%%%%%%%%%%%% %%%%% % %%% %%% % %%%%% %%%%%%%%%%% %%%%% % %%%%% %
%   %%%%%%%%% %%%%%%%%% % %%%%%%%   %%%%%       % %%%%% % %   %     %%%   %   %%%       %     %%%   %
%%% %%%%%%%%% %%%%%%%%% %%%%%%%%% %%%%%%% %%% %%% %%%%% %%% %%% %%%%%%%%% %%% %%% %%%%% % %%%%%%%%% %
%%%     %     %%%%%     %%%       %%%%% %   % %%% %%%   %%% %     %   %%%   %   %   %   %   %%%     %
%%%%% % %%% % %%%%%%% %%%%% %%%%%%%%%%% %%% % %%% %%% % %%% % %%% % %%%%%%% %%% %%% % %%% %%%%% %%%%%
%%%%% %     %   %%%%%       %%%%%     %     %   %     %   % % %%%   %%% %%%     %   % %   %%%%% %%%%%
%%%%% %%%%% %%%%%%%%% %%%%% %%%%% %%% % %%% % %%%%% %%%%% % %%%%%%% %%% %%% %%%%% % %%% %%%%%%% %%%%%
%%%%%   %%% %%%%%%% % % %%%   %     %   %%% % %%% % %%%   %   %   %     %%% %%%%% % %%%         %%% %
%%%%%%% %%%%%%%%%%% % % %%% %%% %%% %%%%%%% % %%% % %%% %%%%% %%% %%%%% %%%%%%%%% %%%%%%%%% %%% %%% %
%%%%%%%   %%%%%%%         %   % %%%   % %%% % %%%   %%% %%%   %%%     %   %%%%%%% %%%%%     %%%     %
%%%%%%% %%%%%%%%% %%% %%% %%% % %%%%% % %%% % %%% %%%%%%%%% %%%%%%% %%% %%%%%%%%% %%%%%%% %%%%%%%%% %
% %%% %   %%% %%% %%% %%% %%%     %%%   %%% %     %%%%%%%%% %%%%%%%     %%%       %   %%% %%% %%%%% %
% %%% % % %%% %%%%%%% %%%%%%%%%%% %%%%%%%%%%%%%%%%%%%%%%%%% %%%%%%% %%%%%%% % %%%%% % %%% %%% %%%%%%%
%     % %   %   %%%%% %%%%%%%%%%% %%%%%%%%%%%     %%%%%       %%%%%         % %%%%% %     %%%   %%%%%
% % %%% % % % % %%%%%%%%%%%%%%%%% %%%%%%%%%%% %%% %%%%%%% %%%%%%%%%%%%% %%% %%%%%%% %%%%% %%% % %%%%%
% %     % % % %   % %%%%%%%       %   %%%%%%% %%%     %%%     %%% %%% % %%% %%%%% % %%%%% %%% % %%%%%
% %%% %%% % %%% % % %%%%%%% %%%%%%% % %%%%%%%%%%% %%% %%%%%%% %%% %%% % %%%%%%%%% % %%%%% %%% % %%%%%
% %%% %%% %     %   %%%       %%%%% % %%%%%%%%%   %%%   %     %   %   %   %%%   %   %%%%%     %   %%%
%%%%% %%% %%% %%%%% %%%%% %%%%%%%%% %%%%%%%%%%% %%%%%%% % %%%%% %%% % %%% %%%%% % %%%%%%%%%%%%%%% %%%
%%%   %%%   % %%%%%   %%% %%%%%       %%%%%%%   %%%%%   % %%%   %%% % %     %%%   %%%               %
%%%%% %%%%% %%%%%%% %%%%% %%%%%%%%%%% %%%%%%% % %%%%%%%%% %%%%% %%% % % %%%%%%% %%%%%%%%% %%%%%%%%%%%
% %%% %   % %%% %%% %%% %             % %%%   % %%% %%%   % %%%   % %     %%%       %%%%%       % %%%
% %%% % % % %%% %%% %%% %%%%%%%%%%%%% % %%% % %%%%% %%% %%% %%%%% % %%%%%%%%%%% %%% %%%%%%%%%%% % %%%
%       % %       %     %%%%%   %%%%%     % % %%%       %%%       % %%%%%%%%%%% %%%   % %%%%%%%   % %
% %%%%%%% %%% %%% %%%%% %%%%% %%%%%%%%%%% %%% %%% %%%%% %%%%% %%%%% %%%%%%%%%%%%%%%%% % %%%%%%%%% % %
% %%%     %%% %%% %           %%%%% %%%%% %%% %%% %%%%%   %%% %       %%%%%%%%%%% %%%   %   %%%%% % %
%%%%% %%%%%%%%%%% %%% %%%%%%% %%%%% %%%%% %%% %%%%%%%%% % %%% % %%%%% %%%%%%%%%%% %%%%% % % %%%%% % %
%%% % %%%   %%%%% %%% %%%%%%%   %     %   %     %%%%%   %   %   %%%%% % %%% %%%     %   % %   %%%   %
%%% % %%%%% %%%%% %%% %%%%%%%%% %%% %%% %%%%% %%%%%%% %%%%% %%%%%%%%% % %%% %%% %%% % %%%%% %%%%% %%%
% %   %%%   %%%     %       %%% %   %%% %%%%%   %%%       %   %%%       %   %%% % % %   %%%   %%% %%%
% % %%%%% %%%%%%%%% %%%%%%%%%%% % %%%%% %%%%%%% %%%%%%%%%%%%% %%% %%%%% % %%%%% % % %%% %%% % %%% %%%
%   %     %%%%%%%%% %%%%%     % % %%%       %%%   %%%%%%%%%%% %   %%%     %%% % % % %%% %%% % %%%   %
% %%%%%%% %%%%%%%%% %%%%% %%% % % %%% %%%%% %%% % %%%%%%%%%%% %%% %%% %%%%%%% % % % %%% %%%%% %%% %%%
%     %%%     %%%   %%%   %%% %     % %%%%%     % %           %%% %%% %   %%% %   %     %%%%% %%% %%%
%%%%% %%%%% %%%%% %%%%% %%%%% %%%%%%% %%%%%%%%%%%%% %%%%%%% %%%%%%%%%%% % %%% % %%%%%%%%%%%%% %%%%%%%
%   %   %%%     %       % %%%   %   % %%% %%%%%     %%%%%%% %%% %     % %       %%%%%         % %%%%%
% %%% %%%%%%% %%%%%%%%%%% %%%%% % % % %%% %%%%% %%%%%%%%%%%%%%% % %%% % %%%%%%%%%%%%%%% % %%% % %%%%%
%     %%% %%% %%% %%%%%   %%%%%   %   %     %%% %%%%%%%%%%%%%     %%%   %%%   %%% %%%%% % %%%     %%%
% %%%%%%% %%% %%% %%%%%%% %%%%%%%%%%%%% %%% %%% %%%%%%%%%%%%%%% %%%%%%%%%%% % %%% %%%%%%% %%% %%%%%%%
%         %%%   %         %%%     %%%   %     %         %%%%%%% % %   %     %     %       %%% %%%%%%%
%%%%%%%%% %%% % %%% %%% % %%%%% % %%%%% % %%% %%%%% %%%%%%%%%%% % % % % % %%%%%%% % %%% %%%%%%%%%%%%%
%%%   %%% %   % %%% %   %   %%% % %%%%% %   % %%%%%   %%%     % %   %   % %   %%%   %%% %%% %%% %%%%%
%%% % %%% % %%% %%%%% %%% %%%%% % %%%%% %%% %%%%%%%%% %%%%% %%% %%% %%%%% %%% %%%%% %%% %%% %%% %%%%%
%%% %     % %%%       %%% %%%%% %       %%%   %%%     %%%%%     %%% %%%%% %     %%% %%% %       % %%%
%%% %%%%%%% %%%%%%% %%%%% %%%%%%%%%%% %%%%%%% %%% %%%%%%%%% %%%%%%%%%%%%% % % %%%%%%%%% %%%%% % % %%%
%%%       % % %%%   %%% %   % %%%%%%%     %%%   %     %     % %%%%%%%%%%% % % %%%%%%% %   %   %     %
%%%%%%%%% % % %%%%%%%%% %%% % %%%%%%%%%%% %%% %%%%%%% % %%%%% %%%%%%%%%%% % %%%%%%%%% %%% % %%%%%%% %
%%%%%       %   %%%%%%%   %   %%%   %%%%% %%% %%%%%%%   %%%     %%% %%%%% %           %%% % %%%%%%% %
%%%%%%%%% %%%%% %%%%%%%%% % %%%%% %%%%%%% %%% %%%%%%%%%%%%% %%%%%%% %%%%% %%% %%%%%%% %%% % %%%%%%% %
%%% %%%%% %%%%% %%%       % %%%%%     %     % %%% %%%       %%%%%   %%%     % %%%%%%%     % %%%%%%% %
%%% %%%%%%%%%%% %%%%% %%% % %%%%% %%% % %%%%% %%% %%%%%%% % %%%%% %%%%%%%%% %%%%%%%%%%% %%% %%%%%%%%%
%       %%%%%%%       %%% % %%%     %   %     %%%   %%%%% % %%%       %%%%% %%%%%%%%%%%       %   %%%
% %%%%% %%%%%%%%%%% %%%%%%% %%%%%%%%%%%%% % %%%%% % %%%%%%% %%% %%%%% %%%%% %%%%%%%%%%%%%%%%% %%% %%%
% %%%%%       %%%%% %%% %   %   %%%%%%%%% % %     %   %%%%%   %   %           %%%       %%%         %
%%%%%%% %%%%% %%%%% %%% % %%% % %%%%%%%%% % % %%%%%%% %%%%%%% %%% % %%% %%%%%%%%%%%%% %%%%%%%%%%% %%%
%%%%%   %   %   %%%           %       %%% % %   %%%   %         % % %   %%% %%% %%%%%     %%%%%   %%%
%%%%%%% % %%%%% %%%%%%% %%%%%%%%%%% %%%%% %%%%% %%% %%% % %%% %%% % %%% %%% %%% %%%%% %%% %%%%%%% %%%
%   %%%   %%%%%   %%%%% %%%       % %%%   %%%     %     % %%% %   %   % %%%       %%% %   %   %%%   %
% % %%%%% %%%%% %%%%%%%%%%%%% %%%%% %%% % %%% %%%%% %%% % %%%%% %%%%% %%%%% %%% %%%%%%% % % %%%%% %%%
% %   %%%   %%%       %%% %%%       %%% %       %%% %%% %   %%% % %%%   %   %%% %%%%%%% %   %%%   %%%
% %%%%%%% %%%%% % % %%%%% %%% %%%%%%%%%%% %%% %%%%%%%%%%%%% %%% % %%%%% % %%%%% %%%%%%% %%% %%% %%%%%
%   %%% % %%%%% % % %%%%%     %%%   % %%% %%% %   %   %%%%%         %   % %   %   %%%   %%%   % %%%%%
%%% %%% % %%%%%%% % %%%%%%%%% %%% % % %%% %%% % % % % %%%%%%%%% %%%%% %%% % % % %%%%%%% %%%%%%% %%%%%
%%%     %     %%% %     %%%%%     %   %%% %%% % %   %   %     % %%%%% %%%   % %     %%%           %%%
%%% %%% %%%%% %%% %%% %%%%%%%%%%%%%%% %%%%%%% % %%%%%%% %%% % % %%%%% %%%%%%% %%%%% %%% %%%%%%%%% %%%
%   %     %%% %%% %   %%% %       %%%   %%%   %   %%%%%     % %   %%%   % %%% %%%%%         %%%   %%%
% %%%%%%%%%%% %%% %%%%%%% % %%% %%%%% %%%%%%% %%% %%%%%%%%%%% % %%%%%%% % %%% %%%%% %%%%%%% %%% %%%%%
%   %   %     %%% %%%%%     %   %%%   %%% %%% %%%   %%%%%     % %%% %%% %     %%%%%   %%%   %%% %%% %
%%% % % % %%%%%%% %%%%%%%%%%% %%%%% %%%%% %%%%%%% %%%%%%% %%%%%%%%% %%% %%%%% %%%%%%% %%%%%%%%%%%%% %
%%%   %     %%%       %%%     %%% % % %%%       % %%%     % %%%%%%%       %%% %%%     %%%%%%%%%%%   %
%%% %%%%%%% %%%%%%%%% %%% % %%%%% % % %%% %%%%% % %%% %%%%% %%%%%%% %%%%% %%%%%%% %%%%%%%%%%%%%%%%% %
%%% %%%%%   %%%       %   % %%%   %       % %%%   % % %%%   %   %%%     %   %%%       %%%%% %%%%%%% %
%%%%%%%%% %%%%% %%%%% %%% %%%%% %%%%%%%%%%% %%%%%%% % %%% % %%% %%%%%%% %%% %%% %%%%%%%%%%% %%%%%%% %
% %%%%%%%   %   %%%%%     %%%   %%%%%               %     % %%% %%% %%% %   %     %%%%%%%     %%%%% %
% %%%%%%%%%%% % %%%%% %%%%%%% % %%%%%%% %%%%% %%% %%%%% %%% %%% %%% %%% % %%%%%%% %%%%%%% %%% %%%%% %
%             %   %%% %%%%%%% %   %%%%% %%%%% %   %%%%% %%% %%%         %   %%%%% %%% %%% %%%       %
%%%%% %%% %%%%% %%%%% %%%%%%% %%% %%%%% %%%%% %%%%%%%%%%%%% %%% %%%%% %%%%% %%%%%%%%% %%% %%% % %%%%%
%     %%% %%%%% %%%%%         %%% %   % %%% %   %%%%%%%%% %   % %%%%% %%% %       %%%   % %%% % %%%%%
% %%% %%%%%%%%%%%%%%%%%%%%% %%%%% % %%% %%% %%% %%%%%%%%% %%% %%%%%%% %%% %%%%% % %%% % % %%% %%%%%%%
% %%%   %%%   %         %%% %%%     %   %     %   %%%%% %     %%%           %%% % %%% % %   %   %%% %
% %%%%%%%%% %%% %%% %%% %%%%%%% %%%%% %%%%%%% %%% %%%%% % %%% %%%%%%%%%%% %%%%%%% %%% %%%%% %%% %%% %
%   %%%%%%%     %%% %%%   %%%     %   %       %%%         %%%   %   %%%%% %%%%%%%   %       %%% %%% %
% %%%%%%%%% %%%%%%% %%% % %%%%%%% % %%% %%% %%%%%%%%%%%%%%%%%%% % % %%%%%%%%%%%%% % % %%%%%%%%% %%% %
%         %   %%%%%   % % %%%%%%% % %   %%% %%%%%%%%%%%%%%%     % %       %   %%% %   %%%%%%%%%     %
% %%%%%%% % %%%%%%%%%%% %%%%%%%%% % % % %%%%%%%%%%%%%%%%%%%%% %%% %%%%%%% % % %%%%%%%%%%%%%%%%% % % %
%   %%%%%   %%%%%%%%%%%       %%% %   % % %%%%%%%%%%%%%   %%% %%%!%%%%%%%   %       %%%%% %%%   % % %
%%% %%%%% %%%%%%%%%%%%% %%%%% %%% % %%% % %%%%%%%%%%%%% %%%%% %%% %%%%%%% %%%%%%%%% %%%%% %%%%% % %%%
%%% %%%%% %%%%%%%%%   %     % %   % %%% % %%%%%%%%%%%             % %%%   %%%       %     % %%% %   %
%%%%%%%%%%%%%%%%%%% % %%% %%% %%%%% %%% % %%%%%%%%%%% %%%%%%%%%%%%% %%% %%%%% %%%%% % %%% % %%%%%%% %
%%%%%%%%%%%%%%%%%%% %     %%%       %%%         %%%         %%%         %%%     %%%   %%%           %
%%%%%%%%%%%%%%%%%%%%%%%%%%%%%%%%%%%%%%%%%%%%%%%%%%%%%%%%%%%%%%%%%%%%%%%%%%%%%%%%%%%%%%%%%%%%%%%%%%%%%
