%%%%%%%%%%%%%%%%%%%%%%%%%%%%%%%%%%%%%%%%%%%%%%%%%%%%%%%%%%%%%%%%%%%%%%%%%%%%%%%%%%%%%%%%%%%%%%%%%%%%%
%%%%%%%%%   %%% %%% %%%%%%%%%%% %   %%%     %%%     %%% %%% %%%%%%%%%   %%% %%%%%%%   %%%%%%%   %%%%%
%%%%%%%%%%% %%% %%% %%%%%%%%%%% % % %%% %%% %%% %%% %%% %%% %%%%%%%%% %%%%% %%%%%%%%% %%%%%%%%% %%%%%
%   %%% %%% %%% %%%     %%%       %     %%% %%% %%%         %%%%%%%%%                   %%%%%       %
% %%%%% %%% %%% %%%%% % %%% %%%%%%% %%%%%%% %%% %%% %%% %%%%%%%%%%%%% %%% %%%%% %%%%% %%%%%%% % %%%%%
%       %%%           % %%% %%%%%%%   %%%   %%%   %   % %%%%%   %%%   %   %%%%% %%%   %%%     % %%%%%
%%%%% %%%%%%%%% % %%% %%%%%%%%%%%%%%% %%% %%%%%%% %%% % %%%%% %%%%% %%% %%%%%%%%%%%%%%%%% %%%%% %%%%%
%%%   %%% %%%%% % %%% %%% %%%   %%%%% %   %%%%%%% %   % %           %%% %%% %%%%% %%%%%   %%%       %
%%% % %%% %%%%% %%%%% %%% %%% %%%%%%% %%% %%%%%%% % %%% % %%%%%%%%% %%% %%% %%%%% %%%%% % %%%%%%%%% %
%   % %         %%%%%     %%% %%%       % %%%%%%% %   % % %     %%%   %     %%%   %%%   %   %   %%% %
%%% %%% %%%%% %%%%%%% %%%%%%% %%%%%%%%% % %%%%%%%%% % %%% % % % %%%%% % % %%%%%%% %%%%% %%% % % %%%%%
%%% %%%S%%%   %%% %%% %%%%%         %%% % %%%   %%% %   % % % % %%%   % % %%%       %%% %%%   %   %%%
%%% %%%%%%% %%%%% %%%%%%%%%%%%%%% % %%% % %%%%% %%%%% % % %%% %%%%%%% % % %%%%% %%% %%%%%%%%% %%% %%%
%   %     % %%%     %%%%%         % %   %         %%% %     % %%%%%%% % %       %%% % %%% %%% %%% %%%
%%% % %%% % %%% %%% %%%%% % %%%%%%% % % %%% %%%%% %%% %%%%% % %%%%%%%%% %%%%% %%%%% % %%% %%% %%% %%%
%%%   %%%   %   %%% %%%   % %%%     % % %   %%%   %%% %%%       %%%%%%% %%%%% %%%           % %     %
%%%%%%%%% %%% % %%%%%%% % %%%%% %%%%%%% %%% %%%%% %%%%%%%%%%%%% %%%%%%% %%%%%%%%%%% %%%%% %%% % %%% %
%%%%%%%%% %%% % %%%%%   % %%%%%   %%%   %%%   %%% % %%%%%%%     %%%     %%%       % %%%%% %   % %   %
%%%%%%%%% %%%%% %%%%% %%% %%%%%%% %%% %%%%%%%%%%% % %%%%%%% %%%%%%%%%%% %%%%% %%% %%%%%%%%% %%% %%%%%
% %%%   % %   %       %     %%%   %   %%% %%%%% %   %%% %%%   %         %%%%% %%% %   %%%   %%%   %%%
% %%% % % % % %%% %%%%%%%%% %%%%% % %%%%% %%%%% %%% %%% %%% %%% %%%%%%%%%%%%% %%% % % %%% %%%%%%% %%%
%     % %   %   %   %   %%%   %%% %       %%%%%   % %%%     %%%     %%%%%%%   %%%   %   %     %%% %%%
%%% %%% %%%%%%% %%% % % %%%%%%%%% % % %%%%%%%%% %%% %%% %%%%%%%%%%% %%%%%%% %%%%% %%% %%%%%%% %%% %%%
%%%   %   %%% % %%%   %     %%%   % %   %%%%%   %%% %     %%%%%%%%% %       %%% % %   %%% %   %     %
%%% %%% %%%%% % %%% %%%%%%% %%% %%%%%%% %%%%% % %%% %%%%%%%%%%%%%%% % %%%%%%%%% % % %%%%% % %%% %%% %
%   %%% %%%   % %   % %%%   %     %   % %   % %     %%%%%%% %%%         %%%%%     % %%%       % %%% %
% %%%%% %%%%% % %%% % %%% %%%%%%% % % % %%% % %%%%%%%%%%%%% %%%%%%%%%%%%%%%%%%%%%%% %%% %%%%%%% %%%%%
%     %   %%%   %%% %   %     %     %   %   %   %%%   %%%                       %%%       %%%   % %%%
%%%%% %%% %%% %%%%% %%% %%%%% %%%%%%%%%%% %%%%% %%% %%%%% %%%%%%%%%%%%%%%%%%%%% %%%%% %%%%%%% % % %%%
%%%   % %     %%%   %%% %%%%%     % %%% %       %           %%%     %%%%%%% %%%   %%%   %%%   %     %
%%% %%% %%%%%%%%% %%%%% %%%%%%%%% % %%% % %%%%%%%%%%%%%%%%% %%%%% % %%%%%%% %%%%% %%%%% %%% %%% %%% %
% % %       %%%   %%%   %%%       %   % %   %       %%%%%   %%%%% % %%%%%       % % %%% %%%   % %%% %
% % %%% %%%%%%% %%%%% %%%%%%% %%%%% % % %%% % %%%%% %%%%% %%%%%%% % %%%%%%%%%%% % % %%%%%%%%% % %%%%%
%     % %%%%%%% %%%%% %       %     %   % % % %%% % %       % %%% %     %%%%%   %     %%%%%   % %%%%%
%%%%% % %%%%%%% %%%%% % %%% %%%%%%% %%% % % % %%% % % %%% % % %%% %%% % %%%%% %%%%% %%%%%%% %%%%%%%%%
%%%       %%%     %%% % %%% %%%%%%% %%%   % % %   % % %%% % %     %%% % %%%%% %     %%% %%%         %
%%%%%%%%% %%%%%%% %%% % %%%%%%%%%%% %%% %%% % % %%% %%%%%%% %%%%%%%%% % %%%%% % %%%%%%% %%% %%%%% %%%
% %%%%% % % %%%%%     %   %%%         % %%% % %     %   %%%   %%%%%   %         %%%     %     %%% %%%
% %%%%% % % %%%%%%%%%%%%% %%%%%%%%%%% %%%%% % %%% %%% % %%%%% %%%%% %%%%% %%%%% %%%%% % %%%%%%%%% %%%
%       % %             %   %%%%%%%%%     %   %%%     %   %   %%%     %%%   %%%       %     %%%   %%%
%%% %%% % % %%% %%% %%% %%% %%%%%%%%%%% %%%%%%%%%%%%%%%%% % % %%%%%%% %%%%%%%%%%%%%%% %%%%% %%% %%%%%
%%% %%%   % %%% %%% %%% %%% %%%     %%% %%% %   %%%%% %%% % % %%%%%%%   %%%%%   %%%   %%% %   % %%%%%
%%% %%%%%%%%%%% %%%%%%% %%% %%% %%% %%% %%% % % %%%%% %%% % %%%%%%%%%%% %%%%% %%%%%%%%%%% %%% % %%%%%
% %         %%%   %%% %     %   %       %%%   % %%%     %   %%%%%%%     %%%   %%% %%%%%%% %%%     % %
% % %%%%%%% %%% %%%%% % %%%%% % %%%%%%%%%%%%%%% %%%%% %%%%%%%%%%%%%%% %%%%%%% %%% %%%%%%% %%%%%%% % %
%   %%%%%%%     %%%%%   %%%   % %   %%%%%         %%% %%%         %%% %%% %%%   %   %%% %           %
% %%%%%%%%%%%%%%%%%%% %%%%% %%% % % %%%%% % %%%%% %%% %%%%%%% % %%%%% %%% %%% % % % %%% % %%% %%%%%%%
% %%%         % %%%   % %%% %%%   %   %%% % %%% %     %%%%%%% % %%%%%   % %%% %   %   %   %%% %%% %%%
%%%%%%% %%% % % %%%%% % %%%%%%% %%% %%%%% %%%%% %%% %%%%%%%%% % %%%%%%% % %%% %%%%% %%% %%%%% %%% %%%
%%%%%%% %%% %     %%%     %%%   %%% %%%%%     %   % %%%   %%% %   %%%%%   %%% %%%%%   % %%%         %
%%%%%%% %%% %%%%% %%%%% %%%%% %%%%% %%%%%%%%% %%% % %%% %%%%% %%%%%%%%% %%%%%%%%%%%%% % %%%%% %%%%%%%
%%%     %   %%%     %%% %%%   %%%       %     %%% %     %     %%%%%   % %%%%%%%%% %%%   %%%%% %%%%%%%
%%%%% %%% % %%%%% %%%%%%%%%%%%%%% % %%% % %%%%%%% %%% %%% %%% %%%%% %%% %%%%%%%%% %%%%%%%%%%%%%%%%%%%
% %%% %%% % %%%%% %%% %%%         % %%%   %%%       % %%% %%%   %%%           %%%   %%%%%   %%%     %
% %%%%%%% %%%%%%%%%%% %%%%% % %%%%%%%%% %%%%% %%%%% % %%% %%% %%%%%%%%%%% %%%%%%%%% %%%%%%% %%%%% % %
%   %%%     %%% %%%%%   %%% % %%%%%%% % %%%   %%%%%     % % %     %%%%%%% %%%%%       %%%%%   %%% % %
% %%%%%%%%% %%% %%%%% %%%%% %%%%%%%%% % %%%%% %%%%%%%%%%% % %%% % %%%%%%% %%%%%%% % %%%%%%% %%%%%%% %
%           %%%   %     %%%     %%%%%     %%% %%% %%%     % %%% %       % %%%     % %%%     %%% %%% %
% %%% %%%%%%%%% % %%%%% %%%%% % %%%%% %%%%%%%%%%% %%% %%%%% %%%%% %%% % % %%% % %%% %%%%%%% %%% %%% %
% % %           %   %%%       % %%%%%   %%%%%%%   %%% %%%%% %%%%% %%% % %   % %   %   %%%%%         %
% % %%% %%% %%%%%%% %%% %%%%%%% %%%%%%%%%%%%%%%%% %%% %%%%% %%%%%%%%% %%%%% %%%%% %%%%%%%%% % % %%%%%
%   %%% %%% %%%%%%% %%%   %%%%%   % %%%%% %%%   % %%% %%%       %%%   %%%   %%%%%   %   %%% % % %%%%%
%%% %%% %%% %%%%%%% %%% % %%%%%%% % %%%%% %%% % % %%% %%%%% %%%%%%%%% %%% %%%%%%%%% % % %%%%% %%%%%%%
%%% %%% %%%     %%%   % % %   %!      %   %   %     %   %   %%%%%%%%%     %     %%%   %   %%%   %%%%%
%%%%%%% %%% %%%%%%%%% %%% % %%% %%%%% % % % %%%%%%% %%% % %%%%%%%%%%%%%%%%%%% %%%%% %%%%% %%% % %%%%%
% %%% % %%%   %%%%%%%     % %   %%%%%   %   %%%%%%% %   %       %%%     % %%%       %%%%%     % %%%%%
% %%% % %%%%% %%%%%%%%%%%%% % %%%%%%% %%%%% %%%%%%%%% %%% %%% % %%% % % % %%%%%%%%%%%%%%% %%%%% %%%%%
%         %   %       %%%%% %   %%%%% %%%   % %%%%%   %   %%% % %%% % %   %%%     %%%   % %     %%%%%
%%%%%%% %%% %%% %%%%%%%%%%% % %%%%%%%%%%% %%% %%%%% %%% %%%%%%% %%%%% %%% %%% %%% %%% % %%% %%% %%%%%
%%%%%%% %   %%%         %     %%%   %%%%% %%% %%% % %%%     %   %%%   %%%     %       %     %%%     %
%%%%%%%%% %%%%% %%%%% %%% %%% %%%%% %%%%% %%% %%% % %%%%%%% % %%%%% %%%%% %%%%%%% %%%%% %%%%%%%%%%% %
%         % %   %%% %     %%%   %%%   %%%     %%% % %       %       %%%%% %%%%%%% %%%%% %%%%%%%%%   %
%%% %%%%%%% % %%%%% %%%%%%%%% %%%%%%% %%% %%%%%%% % %%% %%%%%%% % %%%%%%%%%%%%%%% %%%%% %%%%%%%%% %%%
%%% %       % %     %%%     % %%%%%%% %%% %       %   %   %%%%% % %         %     %%%   %%%     %   %
%%% %%% %%%%% % %%%%%%% %%% %%%%%%%%% %%%%% %%%%% %%% %%% %%%%% %%% %%%%%%% %%%%% %%% %%%%% %%% %%% %
%     % %       %%%%%%% % %     %%%         %%%%%   % %   %   %     %%%%%%% %%%%% %%% %%%%% %%%   % %
%%%%% % % %%% %%%%%%%%% % %%%%% %%% %%%%%%%%%%%%% %%% % %%%%% %%%%%%%%%%%%% %%%%%%%%%%%%%%%%%%% %%% %
%%%   %   %%% %%%     % % %%% %     %%% %%%   %%%   % %     % %%%   %%% %       %%%%%%%%%%%%%%%     %
%%% %%% %%%%% %%% %%% % % %%% %%%%%%%%% %%% %%%%% % % %%%%% % %%% % %%% % %%%%% %%%%%%%%%%%%%%%%%%%%%
%   %   %%%%% %%%   % % %       %%%%%       %%%   %   %   %       %     % %%%%% %%%%%%%             %
% % %%% %%%%% %%%%%%% % %%% % %%%%%%%%% %%% %%%%% %%%%%%% %%%%%%% %%%%% % %%%%% %%%%%%% %%%%%%%%%%% %
% % %%%   %%%   %%%%% %     % %%%       %%%   %%% %%%%%%%   %%%   %%%%% % %     % %%%           %%% %
% % %%%%% %%% %%%%%%% %%%%% %%%%% %%%%%%%%%%% %%%%%%%%%%%%% %%% %%%%%%%%% %%%%% % %%%%%%%%%%% %%%%% %
% % %%%%% %%% %%%     %%%   %%%   %   %%%%%%%   %%%%%%%%%%%       % %%%   %   %   %%%%%   %%% %%%%% %
% % %%%%%%%%% %%% %%% %%% %%%%%%% % % %%%%%%%%%%%%%%%%%%%%% %%%%% % %%% %%% % %%%%%%%%% % %%% %%%%% %
% %       %       %%% %%%   % %%%   %   %%%%%%%%% %%%%%       %%%   %%% %   %     %%%   % %     %   %
% %%%%%%% %%%%%%% %%%%%%%%% % %%%%%%%%% %%%%%%%%% %%%%%%%%%%%%%%%%% %%% % %%%%%%% %%%%% %%% %%%%% % %
%   %%%   %%%       %%%     %           %%%%%               %%%%%   %%%   %%%%%   %%%%%     %   % % %
%%% %%% %%%%% %%%%%%%%% %%%%% % %%%%%%% %%%%% %%% %%%%%%%%% %%%%% %%%%%%%%%%%%% % %%%%% %%% % % % %%%
%   %   %%%%% %%%       %%%   % %%%     %%% % %%%     %       %%% %%%       %   % %%%   %%% % %   %%%
%%% % % %%%%%%%%% %%%%%%%%% %%%%%%%%% %%%%% % %%%%%%% % %%%%% %%%%%%%%% %%% % %%%%%%% %%%%%%% %%% %%%
%%% % %   %%%   % %         %%%%%%%%% %%%%%       %%% % %%%%%   %   %%%   % %         %%%     %%% % %
%%%%% %%%%%%% % % % %%% %%%%%%%%%%%%% %%%%%%%%%%%%%%% %%%%%%%%% % % %%%%% % %%%%% %%%%%%%%% %%%%% % %
% %%% %%%%%   %   % %   %%%       %%%     %%%%%%%     %%%%%%%%% % %     % %   %%%   %%%%%   % %%%   %
% %%% %%%%% %%% %%%%% %%%%% % %%%%%%%%%%% %%%%%%% %%% %%%%%%%%% % %%%%% % %%% %%%%%%%%%%% %%% %%%%% %
%       %   %%% %%%%% % %   %   %%%%%%%   %       %%% %%%%%%%%%   %       %%%   %%%%%     %%% %     %
%%% % % % %%%%% %%%%% % % %%%%% %%%%%%% %%%%% % %%%%%%%%%%%%%%%%%%% %%% %%%%%%% %%%%% % %%%%% % %%%%%
%%% % % % % %%%   %%% %     %%%         % %%% % %%%%%%%%%%%%%%%%%   %%% %%%   %   %   % %%%     % %%%
%%%%% %%% % %%%%% %%% %%% %%%%%%% %%%%% % %%% % %%%%%%%%%%%%%%%%%%% %%%%%%% %%%%% % %%%%%%%%%%% % %%%
%%%%%       %%%%%     %%% %%%%%%% %%%%%       %   %%%%%%%%%%%%%%%%% %%%%%           %%%%%%%%%%%     %
%%%%%%%%%%%%%%%%%%%%%%%%%%%%%%%%%%%%%%%%%%%%%%%%%%%%%%%%%%%%%%%%%%%%%%%%%%%%%%%%%%%%%%%%%%%%%%%%%%%%%
