%%%%%%%%%%%%%%%%%%%%%%%%%%%%%%%%%%%%%%%%%%%%%%%%%%%%%%%%%%%%%%%%%%%%%%%%%%%%%%%%%%%%%%%%%%%%%%%%%%%%%
%%%             %%%%%%%         %%% %%%%%%%%%%%%%     %%% %%%     %%%           %%% %%%   %%%       %
%%% %%%%%%% %%%%%%%%%%%%%%% %%% %%% %%%%%%%%%%%%% %%% %%% %%% %%% %%% %%%%%%%%% %%% %%%%% %%% %%% %%%
%     %%%%% %%%%% %%%%%%%%% %%%     %%%     %%%   %   %%% %%%   % %   %   %%%%%     %%%   %%% %%% %%%
% %%% %%%%% %%%%% %%%%%%%%%%%%% %%% %%%%%%% %%%%% %%%%%%% %%%%%%% % %%%%% %%%%%%% %%%%% % %%% %%% %%%
% %%% %%%         %%%%% %%%%%     %   %%%%% %%%   %%%%%%%       %         %%%%%%% %%%   % % %   %   %
%%%%% %%%%% %%% %%%%%%% %%%%%%%%% % %%%%%%% %%% %%%%%%%%%%% %%% %%%%%%%%% %%%%%%% %%% %%% % % %%% % %
%%%     %%% %%% %%% %%%     %%%%% % %%%       % %%%         %%% %   %     %%%%%       % % %   %%% % %
%%% %%% %%%%%%%%%%% %%%%% %%%%%%%%% %%% % %%% % %%% %%% %%%%%%% % % % %%%%%%%%%%% %%%%% % % %%%%% %%%
%   %     %%%%%%%   %%%%% %%%       %%% % %%%   %%% %%% %%%%%     % % %%%%%   %%% %%%   % % %%%   %%%
%%% %%% %%%%%%%%%%% %%%%% %%% %%%%%%%%%%% %%%%% %%% %%% %%%%%%% %%% %%%%%%% % %%% %%%%% % %%%%%%% %%%
%   %%% %%% %%% %%%   %%% %%%   %%%%%%%%% %   % %%% %%%     %%% %%%   %%%   % %%%   %%%     %%%%%   %
% %%%%%%%%% %%% %%% %%%%% %%% % %%%%%%%%% % % % %%%%%%%%% %%%%%%%%%%% %%%%% %%%%% %%%%%%%%% %%%%%%% %
% %%% %%%%%         %%%       %   %%%     % %     %%%     %%% %%% %%%     %       %%%%%%%     %%%%% %
% %%% %%%%% %%%%% % %%%%%%%%% %%% %%%%% %%% %%%%%%%%% %%%%%%% %%% %%%%%%% %%% %%% %%%%%%% %%% %%%%% %
% %%%       %%%   % %%%%%%%%% %%%       %       %%%               %%%%% %   % %     %%%%% %%%   %   %
% %%% %%%%%%%%% %%% %%%%%%%%% %%%%% %%%%% %%% %%%%% %%%%%%%%%%%%% %%%%% %%% % %%% %%%%%%%%%%%%% %%% %
%       %%%%%%%   %   %%%%%%% % %%%     % %%% %%%%%   %   %%%%%   %   %     % %%% %%%%%%%%%         %
% %%%%%%%%%%%%%%% %%% %%%%%%% % %%%%%%% % %%% %%%%% %%% % %%%%% %%% %%% %%%%% %%%%%%%%%%%%% %%%%%%%%%
% %%%%%%%%%%% %%%   %   %%%       %%%%% % %%% %%%%% %   %     % %%%       %%%       %%%%%%%     %%%%%
% %%%%%%%%%%% %%%%% %%% %%%%% %%%%%%%%% %%%%% %%%%%%% %%% %%% % %%% %%%%%%%%%%%%% % %%%%%%%%% %%%%%%%
%     %%%           %%%   %%% %%%%%   %     % %%%     %   %%%   %%%   %%%%% %%%   %   %%%     %%%   %
% %%%%%%%%% %%%%%%%%%%%%%%%%% %%%%% %%%%%%% % %%%%% %%%%%%%%%%%%%%%%% %%%%% %%% %%%%%%%%%%%%%%%%%%% %
% %%%%% %%% %%%         %%% % %     %%%%%  !%       %%%%%%%         %   %%%                 %%% %%% %
% %%%%% %%% %%% %%%%%%% %%% % % %%% %%%%% %%%%%%%%%%%%%%%%% %%%%%%% %%% %%% %%%%%%%%%%%%%%% %%% %%% %
% %%%%%       % %     %   %   % %%% %%%   %%%           %%%   %%%%%   % %   %%%%%%%%%%%   %     %%% %
%%%%%%%%%%% % % %%%%% %%% % %%%%%%% %%%%% %%% %%%%%%%%% %%%%% %%%%%%% % %%% %%%%%%%%%%% %%% %%% %%% %
%%%         % % %%%%%   %           %%%%%   % %%%%%   %     %   %%%%% % %%%     % %%%   %   %%% %%% %
%%%%% %%%%%%%%% %%%%%%% %%%%% %%%%%%%%%%% %%% %%%%% % %%%%% % % %%%%%%% %%% %%% % %%%%% % %%%%% %%% %
%%%%%     %     %         %%% %%%%%%%     %%%   %   %       % % %%%       % %%%         %   % %     %
%%%%%%%%% % %%%%% %%%%%%% %%%%%%%%%%% %%% %%%%% % % %%%%%%% %%% %%% %%%%% %%%%%%%%% %%%%%%% % %%%%% %
%%%%%%%%% % % %%% %%%     %%%%%   %   %%%       % % %%%%%%% %%%     % %%%     %%%%% %%%%%   % %     %
%%%%%%%%% % % %%% %%%%%%% %%%%%%% % %%%%% %%%%%%% %%%%%%%%%%%%%%%%% % %%%%% %%%%%%%%%%%%% %%% % %%% %
%%%%% %   % % %%%   %%%%%   % %%%   %%%       %%% %     %%%%%%%%%%%   %%%%% %%%%%%%   %%% %     %%% %
%%%%% % % % % %%% %%%%%%%%% % %%%%%%%%%%%%%%% %%% % %%% %%%%%%%%%%% %%%%%%% %%%%%%% % %%% % %%%%%%% %
%%%   % %   %     %%%%%%%     %%%%%%%%%%%%%%% %%% %   %     %%%     %%%%%   %   %   % %%% %   %%%   %
%%% % % %%%%% %%% %%%%%%%%%%%%%%%%%%%%%%%%%%%%%%% %%% %%%%% %%% %%%%%%%%%%% % % %%% % %%% % %%%%%%% %
%   % %   %%% %%% %%% %%%     %     %%%%%%%%%       % % %%%   % %       %%%   % %   %     % %%% %%% %
% %%% %%% %%% %%%%%%% %%% %%% %%% %%%%%%%%%%% %%% %%% % %%%%% %%% %%% % %%%%%%% % %%% %%%%% %%% %%% %
% %%% %%%   %   %%%%%     % %     %%% %%% %%%   % %%%     %%% %%% %%% %     %     %%% %%%   %   %%% %
%%%%% %%%%% %%% %%%%%%% %%% %%%%% %%% %%% %%%%% % %%%%% %%%%% %%% %%%%%%% % % %%% %%%%%%% %%%%% %%%%%
%%%     %%%       %%%   % %       %   %%%       %   %%% %%% %       %%%%% % % %%% %%%%% % % %%%   %%%
%%%%% %%%%%%%%%%% %%% %%% % %%%%%%% %%%%% %%%%% %%%%%%% %%% %%%%%%% %%%%%%% %%%%%%%%%%% % % %%%%% %%%
%     %%%%%       %%% %%%   % %%%           %   %%%%% % %       %%% %   %%%       %     % %   %%%   %
% %%% %%%%%%% %%%%%%% %%% %%% %%% %%%%%%%%% %%%%%%%%% % % %%% %%%%% %%% %%%%%%% % %%% %%% %%% %%% %%%
% %%% %%%%%%%     %%% %   %   %       %%%%%   %%%%%   %   %   %%% % %%%   %%%%% % %%%     %   %%%   %
% %%%%%%%%%%%%% %%%%% %%% %%% % %%%%%%%%%%% % %%%%% % % %%%%%%%%% % %%% %%%%%%%%% %%% %%%%% %%%%%%% %
%   %%% %%%     %%%   %%% %%%   %%%%%%%%%   %       %   %%%%%%%%%       %%%%%%%%%   % % %%% %%%%%%% %
%%% %%% %%% %%% %%%%% %%% %%%%% %%%%%%%%%%% %%%%%%% %%%%%%%%%%%%% %%%%%%%%%%%%%%% % % % %%% %%%%%%% %
%%%     %%% %%% %%%%% % % %%%%%       %%%%% % %%%%% %%%   %%% %%% %%%%%%%%%%%%%%% % %         %%%   %
%%% %%% %%% %%% %%%%% % % %%%%%%%%%%% %%%%% % %%%%%%%%% % %%% %%%%%%%%%%%%%%%%%%%%% %%%%%%%%% %%%%% %
%%% %%%     %%% %   % %   % %%%%%%%%%   %%%   %     %   %       %%%%% %     %%% %%% %%%   %   %%%%% %
%%%%%%%%%%%%%%% % % % % %%% %%%%%%%%%%%%%%% %%% %%% % %%%%%%% %%%%%%% % %%% %%% %%% %%%%% % %%%%%%% %
%%%%%     %%%   % %   % %%%         %%%   % %   %   % %%%     %%%%%%%   %%%           %%%   %       %
%%%%% % % %%%%% % %%%%% %%%%%%% %%% %%% % %%% %%% %%% %%%%% %%%%%%%%% %%%%%%%%% %%%%% %%%%% % %%%%% %
%%%%% % %     % % %%% %         %%% %   %     %%% %%%   %%%       %   %     %%% %%%%% %%%%%   %%%   %
%%%%%%% %%%%% %%% %%% %%%%%%%%% %%% % %%%%%%%%%%% %%%%% %%%%%%%%% % %%% %%% %%% %%%%% %%%%% %%%%%%% %
%   %%% %%%%% %%% %       %%%   %%%   %   %     %   %   %   %%%   %     %%%   %   %   %%%   %%%%%%% %
% % %%% %%%%% %%% % % %%% %%%%% %%%%%%% % % % %%%%% % %%% % %%%%% %%%%%%%%% %%%%% %%%%%%%%%%%%%%%%% %
% %     %   % %%% % %   % %%%%%   %%%%% % % % %%%     %%% %   %%%   %     % %%%%%       %%%%%   %   %
%%%%% %%% % % %%% % %%% %%%%%%%%%%%%%%% % %%% %%%%%%%%%%% %%% %%%%% % %%% %%%%%%%%%%%%% %%%%% %%% %%%
%%%   %   %       % % % %%% %%%%%%%     %       %%%%%%%   %%% %%%%%   %%%   %%% %%%%%   % %         %
%%% %%% %%% %%%%%%% % % %%% %%%%%%%%% %%%%% %%%%%%%%%%% %%%%%%%%%%%%%%%%%%% %%% %%%%% %%% % %%%%%%%%%
%   %   %%% %%%       % %%% %%%%%     %   % %%%   %%%   %%% %%%%%   %%%%%%%     %%%   % %   %%% %%%%%
% %%% %%%%%%%%%%%%% %%% %%% %%%%% %%%%% % %%%%% % %%% %%%%% %%%%%%% %%%%%%%%%%% %%% %%% % %%%%% %%%%%
% %%%   %%%%%%%%%%% %%%             %%% %       %       %%% %%%%%%%     %%%%%%% %%% %%%             %
% %%%%%%%%%%%%%%%%% %%%%%%%%% %%% % %%% %%%%%%%%%%%%%%% %%% %%%%%%% %%%%%%%%%%% %%% %%%%% %%%%%%%%% %
%   %       %%%%%   %%%%%%%%% %%% %   % %%%   %%%%%%%   %%% %%%%%%% %       %   %     %%% %%%%%   % %
%%% % %%% %%%%%%%%%%%%%%%%%%%%%%%%% % % %%% %%%%%%%%% %%%%% %%%%%%% % %%% %%% %%% %%% %%%%%%%%% % % %
%%%   %%% %%%       %           %%% %   %   %%% %%% %       %%%   %   %%%   % %%% %%%   %%% %%% %   %
%%% %%%%% %%%%% %%% % %%%%% %%% %%% %%%%% %%%%% %%% %%%%% % %%% %%% %%%%%%% % %%%%%%% %%%%% %%% %%% %
%       %   %%%   %   %%%%% %   %   %           %%% %%%%% %     %%% %     %   % %%%   %     %   %%% %
% %%%%% % %%%%%%% %%% %%%%%%% %%%%% %%% %%%%% % %%% %%%%% %%%%% %%% %%%%% %%%%% %%% %%% %%% % %%%%% %
% %%%%% % %%% %%% %%% %   %%%     %   %   %%% %       %%%   %   %%%         %%%       % %%% % %%%%% %
% %%%%% % %%% %%% %%%%% % %%%%%%% %%% %%% %%%%%%% %%% %%%%% % %%%%%%%%%%%%% %%%%% %%% % %%% %%%%%%%%%
%   %%% %     %%% %     %   %     % %   %   %%%%% %%%   %%% % %%%       %     %%% % %   %%% %%%   %%%
%%%%%%% %%%%% %%% % %%%%%%% % %%%%% %%% %%% %%%%% %%% %%%%%%% %%% %%%%% % %%%%%%% % %%%%%%% %%% % %%%
%%%%%     %%%     % %%%%% % % %   %     %     %   %   %%%     %%% %   % %   %%%%%     %%%   %%% %   %
%%%%% %%%%%%%%% %%% %%%%% % % % % %%% %%%%% %%% %%%%% %%%%% % %%% % % %%%%% %%%%%%%%%%%%%%% %%% %%% %
%%%%%   %   %S% %%%   %%%   %   %   % %%%%% %%% %%%%% % %%% % %%%   %       %%%           % %%% %%% %
%%%%%%% % % % % %%% %%%%% %%%%%%% % % %%%%%%%%% %%%%% % %%% %%%%%%% %%% %%%%%%% %%%%%%%%% % %%%%%%% %
%   %%% % %   % %%%   %         % % %   %%%%%%% %%%     %%% %%% %%% %%%     %%% %%% %%%%% %         %
%%% %%%%% %%%%%%%%%%% % %%%%%%% % % %%% %%%%%%% %%%%%%% %%% %%% %%% %%%%%%% %%% %%% %%%%% % %%% %%% %
%     %   %     % %%% % %%%%%   % % %%%     %%%   %%%   %%%     %   % %%%%% %%% %%%     %   % % %%% %
% %%% % %%% %%% % %%% %%%%%%% %%%%% %%%%%%% %%% % %%%%%%%%% % %%% %%% %%%%%%%%% %%% %%% %%%%% % %%% %
%   % %   % %%%       %%% %%% %%%%% %%%%%   %%% %       %%% %   %     %%%%%%%   %%% %%%         %%% %
%%% %%%%% % %%%%%%%%%%%%% %%% %%%%% %%%%% %%%%%%%%%%%%% %%%%% % %%% %%%%%%%%% %%%%% %%%%% %%% %%%%%%%
%%% %%%     %%%%%%%%%       % %     %     %%%%%   %%%%%   %%% %   % %%%       %%%   %%%%% %%% %%%%%%%
%%% %%% %%%%%%%%%%%%% %%% %%% % %%% %%% %%%%%%% % %%%%%%% %%%%% %%% %%% %%% %%%%% %%%%%%%%%%%%%%%%%%%
%   %     %%%%%%%%%%% %%%       %%% %%% %%%     %         %   %   % %%% %%% %%%   %%%   %%% %%% %%% %
% %%% %%%%%%%%%%%%%%% %%%%%%%%%%%%%%%%% %%%%%%% %%%%%%%%% % % %%% % %%% %%%%%%% %%%%%%% %%% %%% %%% %
%     % %%%%%%%   %%% %     %%%%% %%%     %%%   %%%%% %%% % %     % %%%   %%%   %   %%%         %   %
% %%%%% %%%%%%% % %%% %%% %%%%%%% %%%%% %%%%% %%%%%%% %%% % %%% %%% %%%%% %%% %%%%% %%%%%%% %%% % %%%
%         %%%   %   % %%% %%%%%   %%%%% %%%%% %%%%%       %   % %         %       %         %   % %%%
%%%%%%%%%%%%% %%% % % %%% %%%%% %%%%%%% %%%%% %%%%% %%% %%% % %%% %%% %%%%%%%%%%% %%% %%%%%%% %%% %%%
%%%%%%%%%%%   %   % %         % %%%     %     % %%% %%% %%% % %%% %%% %%%%%%%%%       %%%     %     %
%%%%%%%%%%% %%% %%%%% %%%%%%% % %%% %%%%%%%%% % %%% %%%%%%% % %%% %%%%%%%%%%%%% %%%%%%%%%%%%% % %%% %
%%%%%     %   %       %%%%%%% % %%%           %     %%%%%   %       %%%%%       %%%%%%%%%%%%%   %%% %
%%%%%%% % %%% %%%%% %%%%%%%%% % %%% %%% %%%%%%% %%%%%%%%% %%%%% %%%%%%%%% %%%%%%%%%%%%%%%%%%%%% %%%%%
%%%%%%% %       %%% %%%         %%% %%% %%%%%%%     %%%%%   %%%   %%%%%%% %%%%%%%%%%%%%%%%%%%%%   %%%
%%%%%%%%%%%%%%%%%%%%%%%%%%%%%%%%%%%%%%%%%%%%%%%%%%%%%%%%%%%%%%%%%%%%%%%%%%%%%%%%%%%%%%%%%%%%%%%%%%%%%
