%%%%%%%%%%%%%%%%%%%%%%%%%%%%%%%%%%%%%%%%%%%%%%%%%%%%%%%%%%%%%%%%%%%%%%%%%%%%%%%%%%%%%%%%%%%%%%%%%%%%%
%     %%% %%%   %         %%% %%% %%%%%   %%%         %%%%%         %%%%%%%     %%%%% %%% %%%%%%%%%%%
% %%% %%% %%%%% % %%%%% %%%%% %%% %%%%%%% %%%%% %%% %%%%%%%%%%%%%%% %%%%%%% % %%%%%%% %%% %%%%%%%%%%%
% %%%       %%%   %%%%% %%%%%       %%%%% %%%%%   %       %%%%%%%   %%%%%   % %             %%%%%%%%%
%%%%%%%%%%% %%%%% %%%%% %%%%% %%% %%%%%%% %%%%% %%%%% %%%%%%%%%%% %%%%%%% % %%% %%% %%% %%% %%%%%%%%%
%%% %%%%%     %%%     %       %%% %%%%%       % %%% % %%%%%%%%%   %       % %%% %%% %%% %%% %%%%%%%%%
%%% %%%%% %%% %%%%%%%%% % %%%%%%% %%%%% %%% %%% %%% % %%%%%%%%% %%% %%%%% % %%% %%% %%% %%% %%%%%%%%%
%   %%%     %         % % %%%       %%% %%%   %     % %%% %%%       %%%%% % %   %%%   % %     %%%%%%%
% %%%%% %%% %%% %%%%% %%% %%%%%%% %%%%% %%%%% %%% %%% %%% %%%%%%% %%%%%%% %%% %%%%% %%% %%%%% %%%%%%%
%     % %%% % % %%%   %%% %%%%%%% %%% % %%% %   % %         %%%%% %%%%%       %%%   %%% %%%%% % %%%%%
%%% % %%%%% % % %%%%% %%% %%%%%%%%%%% % %%% % %%% % %%%%% %%%%%%% %%%%%%% %%%%%%%%%%%%% %%%%% % %%%%%
%%% %   %%%!%     %%% %   %%%   %%%%%     % % %%% % %%%%% %%% %   %%%   % %%%%% %%%%%   %     % %%%%%
%%% %%% %%% %%%%%%%%% % % %%% %%%%%%%%%%% % % %%% % %%%%%%%%% % %%%%% % %%%%%%% %%%%% %%% %%%%% %%%%%
%     %   % %%%%%%%   % %   %   %%% %%%%%   %     %     %%%%%   %     %   %           %%% %%%     %%%
%%% % %%% % %%%%%%% %%% %%% %%% %%% %%%%%%%%%%% %%%%%%% %%%%%%%%% %%% %%% %%% %%% %%% %%% %%% %%%%%%%
%%% % %     %%%         %%% %   %%%     %%%%%%% %%%%%         %%% %%% %%% %%% %%% %%% %%%     %%%%%%%
%%% % %%% %%%%% %%%%%%% %%% % % %%% %%%%%%%%%%% %%%%% %%% %%% %%% %%%%%%% %%%%%%% %%% %%%%%%%%%%%%%%%
%%% % %%% %%%   %%%     %%%   %     %%%     %%% %   % %%% %%% %%%   %%%     %%%     %   %%%%%%%%%%%%%
%%% % %%%%%%% %%%%%%%%%%%%%%%%%%% %%%%% %%% %%%%% % % %%%%%%% %%% %%%%%%%%% %%% %%%%% %%%%%%%%%%%%%%%
% % % %%%%%   %%% %%%%%%% %%%     %%%   %%%   %%% %   %%%%% % %     %%%%% % %     %%% %%%   %%%%%%%%%
% % % %%%%%%%%%%% %%%%%%% %%% %%%%%%%%% %%%%% %%% %%%%%%%%% % %%% % %%%%% % %%%%% %%% %%% % %%%%%%%%%
%   % %%%         %%%%%%% %%%   %%% %%% %%% %     %%%       % %%% %   %%%   %%%     %     %   %%%%%%%
%%% % %%%%% %%% % %%%%%%% %%%%% %%% %%% %%% %%%%% %%%%% % %%% %%%%%%% %%% %%%%% %%%%% %%%%%%% %%%%%%%
%%% %   %%% %%% %         %%%%%   %   % %     %%%   %%% % %%% %%%%%   %   %%%     %%% %%%     %%%%%%%
%%% % %%%%% %%%%% %%%%%%% %%%%%%% % % % %%% % %%%%% %%% %%%%% %%%%% %%%%% %%% %%%%%%% %%% %%% %%%%%%%
%   %     %   %%% %%%%%%% %%% %%% % %     % % %%%%% %   %%%%%       % %%% %%%   %%%     % %%% %%%   %
%%%%% %%% %%% %%%%%%%%%%% %%% %%%%% %%%%% %%% %%%%% % %%%%%%% %%%%%%% %%% %%%%%%%%%%%%% %%%%%%%%%%% %
%%%%% %%%     % %%%%%   % %%%   %%% %%%   %       % %     %   %%%       % %%%%%%%%%%%%%         %%% %
%%%%% %%%%%%% % %%%%% % % %%% %%%%% %%% %%% %%%%%%% %%% %%% %%%%%%%%% % % %%%%%%%%%%%%% %%%%% %%%%% %
%   % %   %%% % %     % %     %%%   %%%   %     %%% %%%     %%%%%%%%% %   %     %%%         %       %
% %%% %%% %%% % % %%%%% % %%%%%%% %%%%%%% %%%%% %%% %%%%%%%%%%%%%%%%% %%% %%%%% %%%%%%% %%%%%%% %%%%%
%         %%%   % %%%     %%%     %%%   % %     % %   %           %%% %%% %%%%%     %%% %%%%%   %%%%%
%%% %%%%% %%%%% % %%% %%%%%%% %%%%%%% % % % %%% % %%% % %%%%% %%% %%%%%%% %%%%% %%% %%%%%%%%% %%%%%%%
%%% %%%%% %%%%% %   %   %%% % % %%%%% % %   %%%   %%% %   %%%   %     %%%   %   %%%     %%%   %%%   %
%%% %%%%% %%%%%%% % %%%%%%% % % %%%%% % %%% %%%%%%%%% %%% %%%%% %%%%% %%%%% %%% %%%%%%% %%%%% %%%%% %
%   %%%     % %%% % %%%         %%%   % %%% % %%%%%   %%% % %%%   %%%   %%%   % %%%   %     %   %%% %
%%% %%%%%%% % %%%%% %%% %%% %%%%%%% %%% %%% % %%%%%%% %%% % %%%%% %%%%% %%%%% % %%% % %%%%% % % %%% %
%%%   %%%   %   %%% %%% %%% %%%%% % %%%   %   %%% %%%     %   %%% %%%   %%%%% %     %   % % % %   % %
%%%%%%%%% %%% %%%%% %%% %%%%%%%%% % %%% % % %%%%% %%% %%%%% % %%%%%%% %%%%%%% %%% %%%%% % % %%% % % %
%%%%%%% %     %%%   %%% % %%%%%     %%% % % %%%     %   %   % %%%%%   %%%%%   %%% %%%%% %   %%% %   %
%%%%%%% %%%%% %%% %%%%% % %%%%% %%%%%%%%% % %%% % %%%%% % % %%%%%%%%% %%%%% %%%%% %%%%% % %%%%% % %%%
%           % %%% %       %%%%%       %%%   %%% % %%%   % % %%%   %%% %   % % %%% %%%   %   %%% % %%%
% %%%%%%%%% % %%% % %%%%%%%%%%%%% %%%%%%%%%%%%%%% %%% %%% %%%%% %%%%% % % % % %%% %%%%% %%% %%% % %%%
% %%%%%     % %%%   %%% %%%%% %%% %%%%% %%%%%%%%% %%%   %   %%% %%%%%   % %     %   %%% %%%     % % %
%%%%%%% % %%% %%%%%%%%% %%%%% %%%%%%%%% %%%%%%%%% %%%%% %%% %%% %%%%%%% % %%%%% %%%%%%% %%%%%%%%% % %
%%%%%%% % %             %%%     %%%       %%%%%%%   %%% %%%     %  S%%% % %             %%%     %   %
%%%%%%% %%% %%%%%%%%%%% %%%%% %%%%% % %%% %%%%%%% %%%%% %%% %%%%% %%%%% % %%%%%%%%%%% %%%%%%%%% % %%%
%%% %%%     %%%%%%%           %%%   % %%%   %     %%% %     %%%%% %%%%% % %%%%%   %   %%%%%%%%%   %%%
%%% %%% %%% %%%%%%%%% %%%%% %%%%% %%% %%%%% % %%% %%% %%% %%%%%%% %%%%%%% %%%%%%% % %%%%%%%%%%% %%%%%
%     % %%% %%%%%%%%% %%%   %%%   %%%   %%% %   %     %   %%%     %%% %%%   %%%%%   %%%%%%%       %%%
%%% % % %%%%%%%%%%%%%%%%% %%%%%%% %%%%%%%%%%%%% %%%%% % %%%%% %%%%%%% %%%%% %%%%% %%%%%%%%%%%%%%%%%%%
%%% %   %%%%% %%%%% %%% % %%%%%   %%%%%%%%%%%   %%%%%   %     %%%%%   %%%%%     %   % %%%%%%%%%%%%%%%
%%% %%%%%%%%% %%%%% %%% % %%%%% %%%%%%%%%%%%% %%%%%%% %%% %%%%%%%%%%% %%%%% %%% %%% % %%%%%%%%%%%%%%%
% % %%%%%%%     %%%         %%%           %%% %%%       %     %   %%%       %   %     %%%%%%%%%%%%%%%
% % %%%%%%%%%%% %%% %%%%% %%%%%%% %%% %%%%%%% %%%%%%%%%%%%%%% % %%%%% %%%%%%% % %%% %%%%%%%%%%%%%%%%%
%     %%% %%%%%     % %%% %%% %%% %   %%%     %%%%%%%%%%% %%% % %%%%% %   %   % %%% %%% %%%%%%%%%%%%%
%%%%% %%% %%%%%%% %%% %%%%%%% %%% %%% %%% %%%%%%%%%%%%%%% %%% % %%%%% % %%% %%%%%%%%%%% %%%%%%%%%%%%%
%%%   %%%     %%% %   %%%%%   %%% %%%   %   %%%     %%%     %   %   %   %   %%%%%%%%%   %%%%%%%%%%%%%
%%%%%%%%%%% %%%%% % %%%%%%%%% %%% %%%%%%%%% %%% % %%%%% %%%%%%% %%% % %%% %%%%%%%%%%% %%%%%%%%%%%%%%%
% %%%%%     %%%%%   %%% %%%%%     %         %   % %%% %   %   % %%%   %%% %   %%%%%   %%%%%%%%%%%%%%%
% %%%%%%% % %%%%% %%%%% %%%%%%% % % %%%%%%% %%% %%%%% % % % % % %%% %%%%% % % %%%%%%% %%%%%%%%%%%%%%%
%     %%% % %%% % %%%%%     %%% %     % %%%     %%%     %   %   %%% %%% %   %     %%%     %%%%%%%%%%%
% %%% %%% %%%%% % %%%%%%% %%%%% %%%%% % %%%%%%%%%%% %%%%%%%%%%%%%%% %%% %%%%%%% % %%%%%%% %%%%%%%%%%%
% %%%     %       %%%%%%% %%% %   %%%     %         % %%%%%%%%%%%   %       %%% % %%%%%%% %%%%%%%%%%%
% %%% %%%%% %%%%%%%%%%%%% %%% %%% %%%%% %%% %%%%%%%%% %%%%%%%%%%%%% %%% %%%%%%%%% %%%%%%% %%%%%%%%%%%
%   %   %     %%% %%%%%%%       % % %%% %%% %%%%%       %%%%%   %%%     %%%%% %%%       %   %%%%%%%%%
%%% %%% % %%% %%% %%%%%%% % %%% % % %%%%%%% %%%%% %%%%%%%%%%% %%%%% %%%%%%%%% %%%%% %%% % %%%%%%%%%%%
%   %%% % %%%     % %%%   % %%% %     %%% % %     %             %%% %     %     %%% %%%   %%%%%%%%%%%
% %%%%% % %%% %%% % %%%%% %%%%%%%%%%% %%% % %%%%% % %%% %%%%%%% %%%%% %%% %%% %%%%% %%%%%%%%%%%%%%%%%
%   %%%   %%% %%%     %%% %%%         %%%   %%%%%   %%% %%%         % % %     %%% %       %     %%%%%
%%% %%%%% %%%%%%% %%%%%%% %%% %%%%% %%%%% %%%%%%% %%%%%%%%% %%%%%%% % % % %%%%%%% % %%%%% % % %%%%%%%
%     %%% %%%%%%% %%%%%%%   % %%%%%   %   %%% %%%     %%%   %%%%%%%   %   %%%%%%%   % %%% % % %%%%%%%
%%%%%%%%%%%%%%%%%%%%%%%%%%% % %%%%%%%%% %%%%% %%%%% %%%%%%% %%%%%%% %%% %%%%%%%%%%% % %%% % % %%%%%%%
%%%%%%% %%%%%   %%%         % %   %%%%%         %%% %%% %%% %%%%%   %%%       % %%%     %   %       %
%%%%%%% %%%%% %%%%%%% % %%%%% % %%%%%%%%%%% %%% %%%%%%% %%% %%%%% %%%%%%% %%% % %%%%%%% %%%%%%%%%%% %
%   %%%       %%%%%%% % %     %   %%%   %%% %%% %%%%%       % %     %%%   %%%   %   %%% %       %%% %
%%% %%%%% %%%%%%%%%%% %%% %%%%%%% %%% % %%%%%%% %%%%%%% %%%%% % %%%%%%% %%%%%%% % % %%% % %%% %%%%% %
%%%   %%%   %%%%%%%     %         %   %   %%% %         %%%%%   %%%%%   %%% %%%   % %%%   %   %%%   %
%%%%% %%%%% %%%%%%% %%% %%%%%%%%% % %%%%% %%% %%%%%%%%%%%%%%%%%%%%%%%%%%%%% %%%%%%% %%%%% %%%%%%%%% %
%%%   %%%     %%%%% % %   %     % %   %%% %%% %%%     %%%   %%%%% %%%%%%%%%       % % %%% %%%       %
%%% %%%%% %%%%%%%%% % % % % %%% % %%%%%%% %%% %%%%% % %%% % %%%%% %%%%%%%%%%% % %%% % %%%%%%% %%%%% %
%   %%%   %%%%%%% % % % % % %%% % %%%%%       % %%% %   % %   %%%     %%%%%%% % %%%           %%%   %
% %%%%% %%%%%%%%% % % % % %%%%% % %%%%% % %%% % %%%%%%% % % %%%%% %%% %%%%%%% %%%%%%%%%%%%% %%%%%%% %
%       %%% %%%       % % %%%   % % %%% % %%%   %%%%%   % % %%%   %%%     %%%       %%%     %%%%%%% %
% %%% % %%% %%%%%%% %%% % %%% %%% % %%%%% %%%%% %%%%% %%% % %%%%%%%%% % %%%%%%% % %%%%% %%%%%%%%%%% %
% %%% %       %%%%% %%% % %   %%%         %%%   %%%   %%% % %%%%%   % % %%%     % %%%%% %%%%%%%%%%% %
% %%%%%%% %%%%%%%%% %%% % %%% %%%%%%%%%%%%%%% %%%%% % %%% % %%%%% % %%% %%%%% %%% %%%%%%%%%%%%%%%%% %
% % %%%%%             % %       % %         % % %   %     %     % % %         %   %%%%%%%       %%% %
% % %%%%%%%%%%%%%%% %%% %%%%%%% % % %%%%% % % % % %%%%%%%%% %%% % % % % %%% %%%%%%%%%%%%% %%% %%%%% %
% %   %%%%%   %%%%% %   %   %     %   %%% % % %   %%%   %%%   %   %   % %%% %%%%%%%%%%%%% %%% %%% % %
% %%% %%%%%%% %%%%%%% %%% % % %%% %%% %%%%% % %%% %%%%% %%%%% %%% %%%%% %%%%%%%%%%%%%%%%% %%%%%%% % %
%                 %   %   %   %%%   % %%%%% % %%%       %%%%% %   %%%%% % %%%%%%%%%%%       %%%%%   %
% %%% %%%%%%%%%%% % % %%%%%%%%%%%%%%% %%%%% % %%%%%%% %%%%%%% %%%%%%%%% % %%%%%%%%%%%%% %%% %%%%%%%%%
% %%% %%%%%%%%%   % % %     %%% %     % %%%   % %%%   %%%       %%% %%%     %%%%%%% %%% %       %%%%%
% %%%%%%%%%%%%% %%% %%% %%% %%% % %%%%% %%%%%%% %%%%%%%%%%%%%%% %%% %%%%%%% %%%%%%% %%%%% %%% %%%%%%%
% %%%%%%%%%%%%% %%% %%% %%%     %   %%%             %               % %%%     %%%       % %%% %%%   %
%%%%%%%%%%%%%%%%%%% %%% %%%%%%% %%% %%% %%%%%%% %%% % %%% %%%%% %%% % %%%%%%% %%%%% %%% % %%%%%%%%% %
%%%%%%%%%%%%%%%%%     % %%%     %%%     % %     %%% % %   %%%%% %%%     %%%%%   %%% %       %%%%%   %
%%%%%%%%%%%%%%%%%%% %%% %%% %%%%%%%%% %%% % %%%%%%% % % %%%%%%%%%%%%%%% %%%%%%% %%% % %%%%% %%%%% %%%
%%%%%%%%%%%%%%%%%%%     %%%           %%%       %%%   % %%%%%%%%%       %%%%%%%     %   %%%       %%%
%%%%%%%%%%%%%%%%%%%%%%%%%%%%%%%%%%%%%%%%%%%%%%%%%%%%%%%%%%%%%%%%%%%%%%%%%%%%%%%%%%%%%%%%%%%%%%%%%%%%%
