%%%%%%%%%%%%%%%%%%%%%%%%%%%%%%%%%%%%%%%%%%%%%%%%%%%%%%%%%%%%%%%%%%%%%%%%%%%%%%%%%%%%%%%%%%%%%%%%%%%%%
%   %     %%% %%%     %%%%%     % %%%   %%%%%%%%% %%%%%   %%%     %     %         %%%%%%% %%%       %
% % % %%% %%% %%% %%% %%%%%%% % % %%%%% %%%%%%%%% %%%%% %%%%% %%% % % %%% %%%%%%% %%%%%%% %%%%% %%%%%
% %   %   %%%     %%% %%%     %       %           %     %%%   %%%   %   % % %%%%%   %%%%%   %%% %%%%%
% %%% %%%%%%% % %%%%% %%% %%%%% %%%%% %%%%%%%%% % % %%% %%%%% %%%%%%%%% % % %%%%% %%%%%%% %%%%% %%%%%
%   % %     % %   %   %%%   %   %%%%% %%%   %%% %   %   % %%%   %%% %%%     %%%   %%%%%%%       %%%%%
%%% %%% %%% % %%% %%%%%%%%% %%%%%%%%% %%% % %%% %%%%%%% % %%%%% %%% %%% %%% %%% %%%%%%%%% %%% %%%%%%%
%%% %%% %%%   %%%       %%% %     %%% %   %     % %%%%%   %%%%% %%% %%% %%% %%%       %   %%% %%% %%%
%%% %%% %%%%%%%%% %%%%% %%% % %%% %%% % %%%%%%%%% %%%%%%% %%%%% %%% %%%%%%% %%%%% %%% % %%%%% %%% %%%
%     % % %%%%%%% %%%   %%%   %%% %%%   % %%%         %%%   %       %%%%%     %%%   % %   %%%       %
% %%% % % %%%%%%% %%% %%%%%%% %%% %%%%%%% %%%%% %%%%%%%%%%% % %%%%%%%%%%%%% %%%%%%% % % %%%%% %%%%%%%
% %%% % %   %%%   %%% %%% %%%   % %   %%%       %   %%%%% % % %%%       %%% %%%%%   %   %%%   %%%%%%%
% %%% % % %%%%% %%%%% %%% %%% %%% % %%%%%%% % %%% % %%%%% % % %%% %%%%% %%%%%%%%%%% %%% %%% %%%%%%%%%
% % %     %%%   %%%   %%%     %   %     %%% %     %   %     % %   %%% %     %%% %%% %%% %%%       % %
% % %%%%% %%% %%%%%%% %%% %%%%% % %%%%% %%%%%%%%%%% % % %%%%%%% %%%%% %%%%% %%% %%% %%%%%%% %%% % % %
%   %%%%% %%% %%%%%%%       %   % %%%%%             % % % %%%%% %       %   %%% %%%   %%% % %%% %   %
%%%%%%%%% %%%%%%%%%%% %%%%%%% % %%%%%%% %%%%%%%%% %%%%% % %%%%% %%% %%% % %%%%% %%%%%%%%% % %%% %%% %
%%%%%%%%%   %%%%% %%% %%%%%%% % %%% %%%       %%% %     %         % %%% %             %       % %   %
%%%%%%%%%%% %%%%% %%% %%%%%%% %%%%% %%% %%%%% %%%%% %%%%%%%%% %%% %%%%% % %%%%% %%%%% %%%%%%%%% %%% %
%%%%%%%%%%% %%%             %     %   % %%%%% %%%%% %%% %%%%% %   %%%     %%%   %%%       %%%   %%% %
%%%%%%%%%%%%%%%%%%%%%%%%% %%%%%%% %%% % %%%%% %%%%% %%% %%%%%%% %%%%%%%%%%%%%%%%%%% %%%%% %%% % %%% %
% %%%%%   %%%%%%%%%%%%%%% %%%   % %%%   %%%       % %       %%%           %   %%%%% %%%%%     % %%% %
% %%%%%%% %%%%%%%%%%%%%%% %%%%% % %%%%%%%%%%% %%%%% %%% %%% %%%%%%%%% %%% % % %%%%% %%%%%%%%%%%%%%% %
%     %   %%%%%%%%%%%   %       %   %%%%%%%%%   %%% %%%   %   %%%%%%% %%%   %   %%% %%% %%%   %%%   %
% %%% % %%%%%%%%%%%%%%% % %%%%%%% %%%%%%%%%%% % %%% %%%%%%% %%%%%%%%%%%%%%% %%% %%%%%%% %%% % %%% %%%
% %   % %%% %%%%%%%%%%%   %%%%%   %%%%%%%%%   %   % %%%%%   %%%         %%%   %     %   %%% %       %
% %%% % %%% %%%%%%%%%%% %%%%%%% %%%%%%%%%%%%%%% %%% %%%%% %%%%% %%%%%%% %%%%% %%%%% %%% %%% %%%%%%% %
%   %   %   %%%%%%%%% %     %   %%%%%%%%% %%%%% %%%       %%%       %     %%% %%%   %%%   %   % %%% %
%%% % %%% % %%%%%%%%% %%% %%% % %%%%%%%%% %%%%% %%%%%%%%% %%%%%%% % %%%%% %%%%%%% %%%%% % %%% % %%%%%
%   % %   %   %%%%%%%     %%% % %%%%%     %%%   %%%%%     % %%%%% % %%% % % %%%%%   %%% %   %   %%%%%
% %%%%% %%% %%%%%%%%% %%%%%%% %%%%%%% % %%%%%%% %%%%% %%%%% %%%%%%% %%% % % %%%%%%% %%% % %%%%% %%%%%
%   %%% %%%           %%%%%%% %%%%%   % %%%%%%%       %%%           %%%   %   %%%   %%% %     %     %
%%% %%% %%%%% %%% %%%%%%%%%%% %%%%%%% %%%%%%%%%%% %%% %%% %%% %%%%% %%%%% % % %%% %%%%% %%%%% %%% %%%
%   %%% %%%%% %%%   %%%   %%%       % %%%%%%%%%%% %%% %%% %%% %   % %%%%%   %     % %   %%%%%     %%%
% %%%%% %%%%%%%%%%% %%% %%%%%%%%%%% % %%%%%%%%%%%%%%% %%%%%%% % % %%%%%%%%%%% %%%%% % %%%%%%%%%%%%%%%
%       %   %%%%%%% %%% %%% %%%     % %%% %%%%% %%%%%   %%%     %   % %%%%%%% %%%     %%%%%   %%%%%%%
% %%%%% % % %%%%%%%%%%% %%% %%% %%%%% %%% %%%%% %%%%%%% %%% %%%%%%% % %%%%%%%%%%% %%%%%%%%% %%%%%%%%%
% %%%%%   %     % %%%           %%%           % %%% %%% %%% %%%     %       %%% % %     %%% %%%%%%% %
% %%%%%%% %%%%% % %%% %%%%%%% %%%%% %%% %%%%% % %%% %%% %%%%%%% %%%%%%%%% %%%%% % %%% % %%% %%%%%%% %
%     %%% %%%%%   %%%   %     %%%%% % % %%%%%   %%%   % %%%     %%% %%%   %%%%%       % %       %   %
%%%%% %%%%%%%%%%% %%%%% %%% %%%%%%% % % %%%%%%%%%%%%% % %%% % %%%%% %%% %%%%%%%%%%%%%%% % %%%%% %%% %
% %%%   %%%%%     % %%% %%%     %%%   % %%% %%%%%%%%% %   % % %%% %     %%%   %%%%%%% %   %%%%%     %
% %%% %%%%%%%%% %%% %%% %%%%%%%%%%%%% % %%% %%%%%%%%% %%% % %%%%% % %%% %%% %%%%%%%%% %%% %%%%%%%%% %
% %   %     %%%     %%%     %%%%%     %       %%%%%%%     % %%%     % %     %         %%% %%%%%%%   %
% % %%% % %%%%%%%%% %%% %%% %%%%% %%%%% %%%%% %%%%%%%%% %%% %%% %%%%% %%% % % % %%%%% %%%%%%%%%%%%% %
%   %%% %S%%%       %%% %%% %%%%%   %%% %%%%%   %%%%%%% %   %     %%% %%% % % % %       %%% %%%%%%% %
% %%%%% %%%%%%% %%% %%%%%%% %%%%%%%%%%% %%%%%%% %%%%%%% %%% %%%%% %%% %%%%% % % %%% %%% %%% %%%%%%% %
%   %   %%% %%% %%% %       %%%%%%%%% %   %     %%%%%%% %%%   %       %%%%%   % %%% %%% %   %%%%%   %
% %%% %%%%% %%%%%%% % %%% %%%%%%%%%%% % %%% %%%%%%%%%%% %%%%% %%%%%%% %%%%%%% % %%%%%%% % % %%%%% %%%
% %%% %       %%%   % %%% %%%%%%%%%%%   %%%           % %   %   %%%%% %%% %%% %   %%%%%   %   %   %%%
%%%%% %%% % %%%%%%%%% %%% %%%%%%%%%%%%% %%%%%%% %%%%% % % % % % %%%%%%%%% %%% %%% %%%%%%%%%%%%% %%%%%
%%% %     % %%% %%%%% %%%   %%%%%%%%%%%   %%%%% %   %   % % % %   %%%%%   %%% %%%   %%%         % %%%
%%% %%%%%%% %%% %%%%% %%%%%%%%%%%%%%%%%%%%%%%%% %%% %%%%% % %%% %%%%%%% % %%%%%%% %%%%% %%%%%%%%% %%%
%!    %%% %         %     %%% %%%%%   %%%%%%%%% %%%   %   %   %   %%%%% %   %%%   %%%%% % %%% %%%   %
% %%% %%% %%%%%%%%% %%%%% %%% %%%%%%% %%%%%%%%% %%%%% % % %%% %%% %%%%%%%%% %%% %%%%%%% % %%% %%% % %
% %%%     %%% %%%   %%%%%       %%%%%     %%%   %   %   % %     %   %           %%% %%%   %       % %
% %%%%%%% %%% %%% %%%%%%%%%%%%% %%%%% %%%%%%% %%% % %%%%% %%%%% %%% % % %%% %%%%%%% %%%%% %%%%% %%%%%
% %   %%% %%% %   %         %   %%%               %       %%% %     % % %%% %%%%%%%   %%%   %   %%%%%
% %%% %%% %%% % %%% %%% %%% % %%%%% %%% %%%%%%%%% %%%%%%%%%%% %%%%%%%%% %%%%%%%%%%%%% %%%%% % %%%%%%%
% %%%     %%% %   % %%% %%% % %%% % %%%   %%%%% % %%%%%           %%%     %               % %     %%%
% %%% %%%%%%% %%% % %%% %%% % %%% % %%%%% %%%%% % %%%%% %%% %%% % %%% %%% % % %%%%% %%%%% % % %%% %%%
% %   %%%%%%% %   % %   %%%   %%%     %%% %%%       %%% %%% %%% %     %   % %     % %%%   % %   % %%%
% %%% %%%%%%% % %%%%% %%%%% %%%%%%%%%%%%%%%%%%%%% %%%%%%%%% %%% %%%%%%%%%%% %%% % %%%%% %%% %%%%% %%%
% %%%   %       %   %   %   %%%%%%%%%%%%%%% %%%%% %%%%%%%     % %       %%% %%% %   %   %%%     %   %
% %%%%%%% %%%%%%% % %%% %%%%%%%%%%%%%%%%%%% %%%%%%%%%%%%%%% %%% % %%%%% %%% %%%%%%% % %%%%%%%%% % %%%
%   %%%%%   %%%   %     %%%%%%%%%%%%%%%%%   %%% %%%%%%%%%%% %%% % %   % %%%   %%% % %       %%% % %%%
%%% %%%%% %%%%% %%%%%%% %%%%%%%%%%%%%%%%% %%%%% %%%%%%%%%%%%%%% % % %%% %%%%% %%% % %%%%%%% %%% % %%%
%%%   %%% %%%%%   %%%%%   %%%%%%%%%%%   %   %%%   %%%%%   %%%   %   %%%           % %     % %%% %   %
%%%%% %%% %%%%%%% %%%%%%% %%%%%%%%%%% % % % %%% %%%%%%% % %%% % %%% %%%%%%%%%%%%%%% % %%% %%%%% % % %
%%%%%                 %%% % %%%%%%%%% %   %     %%%     % %%% %   %   %%%     %%%%%   %%% %%% % % % %
%%%%%%%%%%%%% %%% %%% %%% % %%%%%%%%%%% %%% % %%%%%%% %%%%%%% %%% %%% %%% %%% %%%%%%%%%%% %%% % % %%%
%%%%%%%%%%%%% %%% %%% %%%     %%%%% %%% %%% % %%% %%%         %%% % %     % % % %%%%%%% % %     %   %
%%%%%%%%%%%%%%%%% %%%%%%% %%%%%%%%% %%%%%%%%% %%% %%% %%% %%%%%%% % %%%%%%% % % %%%%%%% % % %%%%%%% %
%%%%%%% %%% %%% % % %%%   %%%%%%%   %%%%% %%%     %%%   % %%%%% %   %%% %%%   %         %   %%%%%%% %
%%%%%%% %%% %%% % % %%% %%%%%%%%%%% %%%%% %%% %%% %%%%% % %%%%% %%% %%% %%%%% % %%% % % %%%%%%%%%%% %
%%%%%%%   %   %   % %%% %%%   %%%   %%%       %%%   %%% % %     %%%     %%%%% % %%% % % %%%%%       %
%%%%%%% %%% % % %%% %%%%%%%%% %%% %%%%% %%% %%%%% %%%%% % % %%% %%%%% %%%%%%% %%%%%%% % %%%%%%%%% %%%
%%%%%%%     %   %%% %%%%%%%%%           %%% %%%%% %%%%% % % %%%     % %%%%%%% %%%     %   %%%   %   %
%%%%%%% %%%%%%%%%%% %%%%%%%%% %%%%%%%%% %%%%%%%%% %%%%%%% %%%%% % %%% %%%%%%% %%% % %%%%%%%%% % %%% %
%%%     %     %     %   %%%%% %   %%%%%       %%%     %%% %%%%% % %   %%% %%% %%% %       %%% %   % %
%%%%% %%% %%% % %%% %%% %%%%% %%% %%%%%%% % % %%%%%%% %%% %%%%%%% % %%%%% %%% %%% %%% %%% %%% %%% % %
%%%%% %   %%%   %%%         % %%% %%% %%% % %   %%%%% %%% % %%%   % %%%%%   % %   %%% %%%     %     %
%%%%% %%% %%%%%%%%%%%%%%%%% % %%% %%% %%%%% %%%%%%%%% %%% % %%% %%% %%%%% %%% % %%%%% %%%%%%% %%% %%%
% %%%     %%%       %%%%%%% %   % %%%   %%% %%%%%%%   %%% %     %%%     %     % %%%%%   %%%%% %%% %%%
% %%%%%%%%%%%%% % %%%%%%%%% %%% % %%%%% %%% %%%%%%% %%%%% % %%% %%% %%%%% %%%%%%%%%%% %%%%%%% %%% %%%
%   %%%     %%% % %%%%%     %%%     %%% %%% %       %%%   %   %   % %%%%%       %%%   %%%     %%%   %
% % %%%%%%% %%% %%%%%%% %%%%%%%%%%%%%%% %%% % %%%%%%%%%%% %%% %%% % %%%%%%%%%%% %%%%%%%%%%% % %%%%% %
% % %%%%%%% %%%       %           %         %     %%%%%%% %%%   % % %%%       % %%%     %%% % % %%% %
%%% %%%%%%% %%%%% %%% %%%%%%%%%%% % %%%%%%%%%%% %%%%%%%%% %%%%% %%% %%%%% %%% % %%% % %%%%%%% % %%% %
%%% %             %%%   %%%   %%%   %       %   %%%   %%% %%%%%   % % %%%   %       % %%%%%%% %     %
%%% % %%% %%%%%%% %%%%% %%% %%%%%%% %%% % %%% %%%%% % %%% %%%%%%% % % %%% %%%%%%%%%%% %%%%%%% %%%%%%%
%%%   %%% %%%%%%% %%%%%     %       %%% %     %%%%% % %%%   %%%%%     %%% %%%%%%%         %%%     %%%
%%% %%%%% %%%%%%% %%%%%%%%% % %%%%%%%%%%%%%%% %%%%% %%%%% % %%%%%%% %%%%% %%%%%%%%%%%%%%% %%% %%% %%%
%   %%%     %%%%% %%% %%%%% %     %%% %%%%%%% %%%   %     % %%%%%%% %%%       %%%%%%%%%%%   % %%% %%%
% %%%%%%% % %%%%% %%% %%%%%%%%%%% %%% %%%%%%%%%%% %%% % %%% %%%%%%% %%%%%%% %%%%%%%%%%%%%%% % %%% %%%
% %%%%%%% %   %%%     %%% %%%%%%% %   %%%   %%%       % %     %%%     %%%%% %%%%%%%%%%%%%   %   %   %
% %%%%%%% %%% %%%%% %%%%% %%%%%%% % %%%%% % %%% %%%%% % %%%%%%%%%%%%% %%%%% %%%%%%%%%%%%% %%%%%%%%% %
% %%%     %%% %%%%% %               %%%   %     %%%%% %   %       %   %%%%% %%%%%%%         %%%     %
% %%%%% %%%%% %%%%%%% %%%%%%% %%%%% %%%%%%% %%%%%%%%%%% % % %%%%% %%%%%%%%% %%%%%%%%% %%%%% %%% % %%%
%   %%%     %             %%% %%%     %%%%% %%%%%%%%%%% %   %%%%%           %%%%%%%%%   %%%     % %%%
%%%%%%%%%%%%%%%%%%%%%%%%%%%%%%%%%%%%%%%%%%%%%%%%%%%%%%%%%%%%%%%%%%%%%%%%%%%%%%%%%%%%%%%%%%%%%%%%%%%%%
