%%%%%%%%%%%%%%%%%%%%%%%%%%%%%%%%%%%%%%%%%%%%%%%%%%%%%%%%%%%%%%%%%%%%%%%%%%%%%%%%%%%%%%%%%%%%%%%%%%%%%
%   %%%%%%%%% %%% %%%     %%%     % %%%   %     %                 % %%%       %%% %%%%%       % %%% %
% %%%%%%%%%%% %%% %%% % %%%%%%% % % %%% %%% %%% % % % %%%%%%%%%%% % %%% %%%%%%%%% %%%%% %%%%% % %%% %
% %%% %%% %%%   %     %     %%% %     %       %   % % %%%%%       %       %%%       %%%   %     %%% %
% %%% %%% %%% %%% %%%%%%%%% %%% %%%%% % %%% %%% %%% %%%%%%% %%% %%% %%%%% %%% %%%%% %%%%% %%%%% %%% %
%   % %%% %       %%%     %     %%%%% % %%% %%% %%%       % %%%   % %%%%%       %%%       %%% % %   %
% % % %%% % %%%%%%%%%%%%% % %%%%%%%%% %%%%%%%%% %%% %%%%% %%%%%%% % %%%%%%%%%%%%%%% % %%%%%%% % % % %
% %   %     % %%% %%%     % %       %       %   %%% %%% % %%%   % %   %   %%%%%     % %%%%%   %   % %
% %%%%% %%%%% %%% %%% %%%%% %%% %%%%% %%%%% % %%%%%%%%% % %%% % % %%% %%% %%%%% %%%%%%%%%%% % %%%%% %
%   %%% %             %     %%%       %%%   %     %%%%% % %%% %   %%% %%% %%% %     %%%     % % %   %
% % %%% %%%%% %%% %%%%% %%% %%% %%%%%%%%% %%%%%%% %%%%% % %%%%% %%%%% %%% %%% % %%% %%%%% %%% % % %%%
% %     %     %%% %%%%% %   %%%     %%%   %%%   %       % % %%%   %%%     %%%   %   %%%%% %     % %%%
% %%%%% % %%% %%%%%%%%% %%% %%%%%%%%%%%%% %%% %%%%% %%%%% % %%%%% %%%%%%%%%%%%%%% %%%%%%% % %%%%% %%%
% %%%%%   %%% %%%%%     %%% %%%%%%%%% %%%   % %%%   %     %   %%%             %%% %%%%%   % %%%%% %%%
% %%%%%%%%%%%%%%%%%%% %%%%% %%%%%%%%% %%%%% % %%% %%% %%%%% %%%%%%%%%%%%%%%%% %%% %%%%% % %%%%%%% %%%
% %%% %%%%%%%%%%% %%% %%%     %%%     %%%   %   %   %   %             %%%%%%% %     %%% % %       % %
% %%% %%%%%%%%%%% %%% %%%%%%% %%% %%%%%%% %%%%% %%% %%% %%%%%%% %%% %%%%%%%%% % %%% %%% %%% %%%%%%% %
% %   %%%%%%%     %   %%%%%%% %%%   %%% % %%%%%     %%%       % %%%       %%% %   % %%%   % %%%%%   %
% % %%%%%%%%%%% % %%% %%%%%%% %%% % %%% % %%%%% %%%%%%%%% %%% %%%%%%% %%%%%%% %%% % %%%%% % %%%%% %%%
%   %%%   %%%%% %     %%%%%%% %%% %   %     %%% %%%%% %%% %%% %%%%%%%         %%% %   %%% %   %   %%%
%%% %%%%% %%%%% % %%% %%%%%%%%%%%%% %%% %%%%%%%%%%%%% %%% %%% %%%%%%% %%%%%%%%%%%%% %%%%% %%% %%% %%%
%     %%%     % % %%%   %%%%%%%%%%% %     %%%%%%%%%%%     %%% %%%     % %%%         %%%             %
%%% %%%%% %%% % %%%%%%% %%%%%%%%%%% % %%% %%%%%%%%%%% %%% %%% %%%%%%% % %%% %%% %%%%%%%%% %%%%%%%%% %
%%% %     %%%   %%%             %%% % %%% %%%%%%% %%% %%% %     %%%%%     % %   % %%%%%%% %%%   %   %
%%%%% %%%%%%%%%%%%% %%%%%%%%% %%%%% % %%%%%%%%%%% %%%%%%%%% %%% %%%%%%%%% %%% %%% %%%%%%%%%%%%% % %%%
%%%%% %     %         %%%%%%% %%%%%     %%% %%%%%     % %%% % %   %%%%%       %%%   %%%%%%%%%%%     %
%%%%% %%%%% % %%%%%%%%%%%%%%% %%%%%%%%% %%% %%%%% %%% % %%% % %%% %%%%%%%%%%% %%% % %%%%%%%%%%%%% %%%
%%%   %%%%% %   %%%       %%% %%%%%%% %           %%%   %   %         %%%%%%% %%% % %   %%%%%%%%% %%%
%%% % %%%%% %%% %%% % %%%%%%% %%%%%%% %%%%%%%%% %%%%%%% %%% % %%%%%%% %%%%%%%%%%% %%% % %%%%%%%%% %%%
%   % %       % %%% %   %   %   %%%       %%% % %%%%%       %     %%% %%%   %%% %     %   %%%       %
% %%% %%% %%% % %%% %%% % % %%%%%%% % %%%%%%% % %%%%%%%%%%%%%%%%%%%%%%%%%%% %%% % %%%%%%% %%% %%%%%%%
% %%%   % %%%   %%% %%%   %   %%%%% %       %   %%% %   %%%           %     %         % %     %%%%%%%
%%%%%%% %%%%%%%%%%% %%%%%%%%% %%%%% %%%%%%% % %%%%% % % %%% %%%%%%%%% %%% %%% %%%%%%% % %%% %%%%%%%%%
%%%%%%% %%% %%%             %   % % %%%%%%%   %%% %   %   % %%%   %%% %%%       %%%     %%%         %
%%%%%%% %%% %%% %%%%%%%%%%%%%%% % % %%%%%%%%%%%%% % %%% % % %%% % %%% %%%%%%%%% %%%%%%% %%% %%%%%%%%%
%   %%% %     %   %%%%%%%%%%%%% % %     %%%%%%%   % %%% %   %   %   %       %%% %%%%%%% %%% %       %
%%% %%% % % %%%%% %%%%%%%%%%%%% % % %%% %%%%%%%%% % %%%%%%%%% %%%%%%%%%%%%% %%% %%%%%%%%%%%%% %%%%% %
%%%   %   %       % %%%     %%% %   %%% %         %   %%%       %%%%%     % %%%   %%% %%%%%%%   % %S%
%%% %%% %%%%%%%%% % %%%%% % %%% %%%%%%%%% %%% %%%%%%% %%%%%%%%% %%%%% % %%% %%%%%%%%% %%%%%%%%% % %%%
%       %%% %%%%%     %%% % %%%           %%%   %%%   %               % %%%     %%%%%   %%%   %     %
% %%% %%%%% %%%%% %%%%%%%%% %%%%%%%%%%%%% %%%%% %%% %%% % %%%%%%%%%%%%% %%% %%% %%%%% %%%%% % %%%%% %
% %%%   %     %%% %%%%%     %%% %%%   %%% %%% %   % %%% % %%%%%%%%%%%   %%% %%%       %%%   %     % %
% %%%%% %%%%% %%%%%%%%% %%%%%%% %%% %%%%%%%%% %%% % %%%%% %%%%%%%%%%% %%%%%%%%%%% %%%%%%% % % %%% % %
% %%% % %%%%%   %%%%%     %%%       %%%%%%%   %%% % %%%%%   %%%       %%%%%%%%%%% %       % % %%% % %
%%%%% % %%%%%%% %%%%% %%% %%% %%%%%%%%%%%%%%% %%% % %%%%%%% %%% %%%%%%%%%%%%%%%%% % %%%%%%% %%%%%%% %
%%%   %   %%%%%       %%%     %       %%%     %%%   %%%     %%%   %%%%%%%%% %%%%% % %%%%%%% %%%     %
%%%%% %%% %%%%% %%%%% %%%%%%% % %%% %%%%% %%% %%%%%%%%% % %%%%%%% %%%%%%%%% %%%%% % %%%%%%% %%% %%%%%
%%%   %   %%%   %%%%%   %%%%%     % %%%   %%% %     %%% %   %   %     %%%   %%% %   % %%% % %   %%%%%
%%% %%% %%%%% %%%%%%% %%%%%%%%%%%%% %%%%% %%% % %%% %%%%%%% %%% %%%%% %%% %%%%% %%%%% %%% % % %%%%%%%
%%%   % %       %%% % %%%   %%%%%%%       %   % %%%   %%%%%   %     %     %%%%% %%%       %   % %%%%%
%%%%% % % %%%%% %%% % %%% %%%%%%%%% % %%%%% %%% %%%%% %%%%%%% % %%%%% %%% %%%%% %%% %%%%% %%%%% %%%%%
%%%%%   % %   % %%%   %%%   %%%%%   % %   % %%% %   %   %     % %%%%% %%% %%%       %     %%%     %%%
%%%%% %%% % % %%%%%%%%%%%%% %%%%%%%%% % %%% %%% %%% % % % %%%%% %%%%% %%%%%%%%%%% %%% %%% %%% %%% %%%
% %%% %   % %     %%%%%%%%% %%%%%%%   %   %   %     % %   %       %   % %%%%%%%%% %%% %%%     %%%   %
% %%% %%%%% %%%%% %%%%%%%%% %%%%%%% %%% % %%% %%%%%%% %%%%%%% %%% % %%% %%%%%%%%% %%%%%%%%%%%%%%%%% %
%   %       %%%%%                   %%% % %%%       % %%%%%%% %%% %     %%%%%     %%%%%%%   %%%     %
% %%%%%%%%% %%%%%%%%%%%%%%%%% %%%%% %%%%% %%% %%%%% % %%%%%%% %%%%%%%%% %%%%%%% %%%%%%%%% % %%% %%%%%
%       %%%   %%%%%%% %%%%%   %%%%% %%%%%     %%%%%       %%%   %%%%%%%   % %%%     %     % %%%   %%%
%%% % %%%%% %%%%%%%%% %%%%%%%%%%%%%%%%%%% %%%%%%%%%%%%%%%%%%%%% %%%%%%%%% % %%%%% % % %%% %%%%%%% %%%
%%% % %%%%% %%%       %%%%%%%%% %%%%%%%%% %%%%%     %%%%%%%%%%%         %   %%%%% % % %%% %%%%%   %%%
%%% % %%%%%%%%% %%%%% %%%%%%%%% %%%%%%%%%%%%%%% %%%%%%%%%%%%%%% % %%%%% %%% %%%%%%% % %%%%%%%%%%% %%%
%%% % %%% %%%   %%% %     %%%       %%% %%%%%   %%%       %%%%% % %%%   %%% %%%%%   %       %%%%% %%%
%%% %%%%% %%%%% %%% %%% % %%%%%%% % %%% %%%%% % %%% %%% % %%%%% %%%%%%%%%%% %%%%% %%%%% %%% %%%%% %%%
%   %%%%%   %%%       % % %%%%%%% %     %%%   %   % %%% % %%% %       %%%   %%%   % %%%   %       % %
%%% %%%%% % %%%%%%% %%% %%%%%%%%% %%%%% %%%%% %%%%% %%%%% %%% % %%%%% %%%%% %%% %%% %%%%% %%%%%%%%% %
%%% %     % %%% %%% %%%     %%%   %     %%%%%         %%% %     %%%%% %%%%%     %       %     %%%   %
%%% % %%% % %%% %%% %%% % %%%%% %%% %%% %%%%%%% %%%%%%%%% % %%%%%%%%% %%%%%%%%% %%%%%%% % %%% %%% % %
%%%   %   % % %     %%% % %%%   %%% %%%   %%%%%   %%%%%%%   %     %%%         % %%%%%%%   %%% %%% % %
%%%%%%% %%% % % %%%%%%%%% %%% %%%%%%%%%%%%%%%%%%% %%%%%%%%%%%%% %%%%%%%%% %%%%% %%%%%%%%%%%%% %%% % %
%       %     %   %%% %%%     %%% %%%%%%%     %   %%%   %%% %%%   %%% %%% %%%   %%%%% %%%%%       % %
% %%%%%%%%%%% %%% %%% %%%%%%% %%% %%%%%%% %%% % %%%%%%% %%% %%%%% %%% %%% %%% %%%%%%% %%%%% %%% %%% %
% %   %%%%%%% %%% %%%     % %     %%%     %   % %   %%%     %%%%% %%% %%%   % %         %%% %%% %%% %
% % % %%%%%%%%%%% %%% %%% % %%%%% %%%%% %%% %%% % % %%%%% %%%%%%% %%% %%%%% % % %%% %%% %%%%%%%%%%% %
%   %         %   %   %%%     %%%   %%% %%%   % % %       %%%         %%%%%   % %   %%% %%%%%%%%%%% %
%%% %%%%% %%% % %%%%% %%%%%%% %%%%% %%% %%% % % %%%%%%% % %%%%% %%%%%%%%%%%%%%% %%%%%%%%%%%%%%%%%%%%%
%%% %%%%% % %           %%%%%   %   %%% %%% %   %%%   % % %%%%%       %%%%% %%%       %%%%% %%% %%%%%
%%% %%%%% % %%% %%%%%%%%%%%%% %%% %%%%% %%%%%%%%%%% % % %%%%%%%%% %%% %%%%% %%%%% %%% %%%%% %%% %%%%%
%   %%%     %%% %%%%%%%%%%%   %%%       %%%%% %%%%% %   %%%%% %%% %     %%% %%%%% %%%               %
% %%%%%%%%%%%%%%%%%%%%%%%%% %%%%%%%%%%%%%%%%% %%%%% %%% %%%%% %%% % %%%%%%% %%%%%%%%% %%% %%%%%%% %%%
% %%% %%%%%%%%%%%%%   %%%   %%% %%%%%%%%%%%   %%%   %     %%%     % %%%%%%%     %%%   %%% %%%%%%% %%%
% %%% %%%%%%%%%%%%% %%%%% %%%%% %%%%%%%%%%% %%%%% %%%%% %%%%%%%%%%% %%%%%%% %%% %%% % %%% %%%%%%%%%%%
% %%%   %%%%%%%     %%% %       %         %       %%%%% %%% %%%%%%% %%%%%   %%%     % %%%   %%%%%%% %
%%%%%%% %%%%%%% % %%%%% %%%%%%% %%%%% %%%%% % %%% %%%%% %%% %%%%%%% %%%%% %%%%% %%% %%%%% %%%%%%%%% %
%%%%%%%   %%%   % %%%   %       %%%%%       % %%% %%%     %     %%% %%%   %%%%%   %   %%% %%%%%%%%% %
%%%%%%% %%%%% %%% %%% %%% %%%%%%%%%%%%%%%%%%% %%%%%%%%%%% %%% % %%% %%%%%%%%%%%%%%%%% %%% %%%%%%%%% %
%             %%% %%% %%%   %%% %%%   %   %%%   %%%%%%% %   % %           %%%         %%% %         %
%%% %%%%%%%%%%%%% %%% %%%%% %%% %%% % % % %%%%% %%%%%%% %%% %%% %%%%%%%%% %%% %%%%%%%%%%% %%% %%%%%%%
%%% %%%%%   %%% %         % %       %   % %%%   %%%%%%%     %%%   %%%   % %%% %%%%% %%% %     %%%%%%%
%%% %%%%% %%%%% %%%%%%%%% % %%%%% %%%%%%% %%% %%%%%%%%% %%%%%%%%% %%% %%% %%% %%%%% %%% % %%%%%%%%%%%
% % %%%     %%%   %%%   %   %     %%% %%% %   %%% %%%   % %%%     %   %   %%% % %%%       %%%%%%%%%%%
% % %%%%%%% %%% %%%%%%% %%%%% %%% %%% %%% %%% %%% %%%%% % %%% % %%% %%% %%%%% % %%% %%%%% %%%%%%%%%%%
% %         %%%     %%% %%%!  %%% %%%   % %%%     %%%%%   %%% % %   %%%     % %   % %%%%% %%%%%%%%%%%
% %%%%%%%%% %%% %%% %%% %%% %%%%%%%%%%% % %%%%% % %%%%%%% %%%%% %%% %%%%%%% % % % % %%%%%%%%%%%%%%%%%
% %%%     %   % %   %%%   %         %%%   % %%% % %   %%% %%%%% %%%     %%% % % %   %%%%%%%%%%%%%%%%%
% %%% %%% %%% %%% %%%%% %%% %%% % %%%%% %%% %%%%% % % %%% %%%%% %%%%% %%%%% % % %%% %%%%%%%%%%%%%%%%%
% %   % %     %%% %%%       %%% %   %%% %   %%%%% % %   %     % %%%%% %   % % % %%% %%%%%%%%%%%%%%%%%
% % %%% %%%%%%%%% %%%%%%% %%%%% %%% %%% %%% %%%%% % %%% %%%%% % %%%%% % % % % % %%%%%%%%%%%%%%%%%%%%%
%   %%%       %   %     % %   %   % %%%     %     % %%% %%%%%   % %   % % %   %   %%%%%%%%%%%%%%%%%%%
% %%%%% %%%%% % % % %%% %%% % %%%%% %%%%%%% % %%%%% %%%%%%%%% %%% % % % % %%%%% %%%%%%%%%%%%%%%%%%%%%
%       %%%%%   %   %%%     %       %%%       %               %%%   %   %       %%%%%%%%%%%%%%%%%%%%%
%%%%%%%%%%%%%%%%%%%%%%%%%%%%%%%%%%%%%%%%%%%%%%%%%%%%%%%%%%%%%%%%%%%%%%%%%%%%%%%%%%%%%%%%%%%%%%%%%%%%%
