%%%%%%%%%%%%%%%%%%%%%%%%%%%%%%%%%%%%%%%%%%%%%%%%%%%%%%%%%%%%%%%%%%%%%%%%%%%%%%%%%%%%%%%%%%%%%%%%%%%%%
%           %   %%%%%%%     %%%%% %%%     %%%%%%% %%%%% %     %%%%% %%% %%%               %%%%%     %
%%% %%%%% % % % %%%%%%% %%% %%%%% %%%%% %%%%%%%%% %%%%% % % %%%%%%% %%% %%% %%%%%%%%%%% % %%%%% %%%%%
%%%   %   %   %       % %%%             %%% %%%         % % %     %   %     %%%   %%%%% %   %%% %%%%%
%%%%% % % %%% %%%%%%% % %%%%%%%%%%% %%%%%%% %%% %%%%% %%% % % % %%% % % %%% %%% % %%%%% %%% %%% %%%%%
%%%   % % %%% %%% %%% %   %%%       %%%%%       %%%%% %%% %   %     %   %%%     % %%%%% %   %   %   %
%%%%%%% %%%%%%%%% %%% % % %%% %%% %%%%%%% % %%%%%%%%%%%%% %%%%%%%%% %%%%%%%%%%% %%%%%%% %%% % % %%% %
% %%%%%       %%%     % % %%% %%% %%%     % %       %%%%% %%%%% %%%       %%%%% %%%%%   %%% % % %   %
% %%%%% %%%%% %%%%% %%%%% %%%%%%% %%% %%% % % %%% %%%%%%% %%%%% %%%%% %%%%%%%%%%%%%%%%% %%% % % % %%%
%   %%%   %%%   %%% %     % %%% % %   %%% %   %%% %%%           %%%%% %%%%%%% %%%     % % %   %   %%%
% % %%%%%%%%% %%%%% % %%% % %%% % %%%%%%% %%%%%%% %%% %%%%%%% %%%%%%% %%%%%%% %%% %%% % % %%%%% %%%%%
% % % %%%%%%% %%%     %%%   %%%     %%%  !%   %%%     % %%%%% %%%%%%%         %   %%%   %     % %%%%%
% % % %%%%%%% %%%%%%%%%%% %%%%% %%% %%% %%%%% %%%%% %%% %%%%%%%%%%%%%%%%% %%%%% %%%%%%%%% %%%%% %%%%%
% %     %%%     %%%%%%%   %%% % %%% %%%         %%%       % %%% %%%%%%%%% %%%   %%%%%%%       % % %%%
% %%%%%%%%% %%%%%%%%%%%%% %%% % %%% %%%%%%%%%%%%%%%%% %%% % %%% %%%%%%%%% %%% % %%%%%%% %%%%% % % %%%
%   %       %       %%%%% %%%   %%%       %%%%%%% %%% %%%     % %%%%%%%     % % % %%% %   %%% %     %
% % % %%% %%% %%% %%%%%%%%%%% %%%%%%%%%%% %%%%%%% %%%%%%%%%%% % %%%%%%%%%%% % % % %%% %%% %%% %%%%% %
% % %   %     %%%       %%% % %%%%%       %   %%%     %%%%%%%   %%%   %%% % % %   %%% %   %%%       %
% % %%% %%% %%%%%%%%% %%%%% % %%%%% %%%%%%%%% %%% %%% %%%%%%%%% %%%%% %%% % % %%% %%% % %%%%%%%%%%%%%
% % %%% %%% %%% %%%%% %   %     %%% %         %     % %%%%%%%%%   %%%       % %%% %%% % %       %%%%%
%%% %%% %%%%%%% %%%%% % % %%%%%%%%% % %%%%%%% %%%%% % %%%%%%%%%%%%%%% %%%%%%% %%%%%%% % %%% %%% %%%%%
%   %%%   %%% %   %     %         %   %%%%%   %   % %         %%%%%     %%%%%   %%%     %%%   %     %
% %%%%% %%%%% % % % %%% %%%%%%%%% %%%%%%%%%%% % % % %%%%% %%%%%%%%%%% %%%%%%% %%%%% %%% %%% %%% %%%%%
%       %%%     %   %%% %   % %%%         %%%   %   %%%   %%%%%%%%%%% %%%         % %%% %%% %%%     %
% %%%%%%%%% %%%%% %%%%% % % % %%%%%%%%% %%%%%%%%%%%%%%% %%%%%%%%%%%%%%%%% %%% %%% %%%%% %%%%%%% %%% %
% %%%%%%%%% %%%%% %%% %   %     %%%     %%% %%% %%%       %     %   %%%%% %%%   % %%%   % %%%%% %%% %
%%%%%%%%%%%%%%%%%%%%% %%% %%%%%%%%% %%%%%%% %%% %%%%% %%% % %%% %%% %%%%% %%%%%%% %%%%% % %%%%%%%%% %
%%%   %%%%%%%   %%%     % %%%%%%%   %%%         %%%%% %%%   %%%     %%%     %%%%%   %%%             %
%%% %%%%%%%%% %%%%% %%% % %%%%%%% %%%%% %%%%% %%%%%%%%%%%%% %%%%%%% %%% %%%%%%%%% %%%%%%% %%%%% %%%%%
%         %%% %   % %%%     %%%   %%%   %     %%% %%%%%%%%% %%%%%%% %%%   %     % %%% %%% %%%%% %%%%%
%%% % %%%%%%% % % % %%%%%%% %%%%% %%% % %%%%% %%% %%%%%%%%% %%%%%%%%%%%%% % %%% % %%% %%%%%%%%% %%%%%
%%% %   %     % %       %%%   %%% %   %     % %%%     %%%     %   %%%   % % %     %     %%%%%%%     %
%%%%%%% % %%% % %%%%%%% %%%%%%%%% %%% %%% % %%%%%%%%% %%%%%%% % % %%% % %%% % %%% % %%%%%%%%%%%%%%% %
%%%     %   %   %%%%%%% %%%%%%%%% %%% %%% %             %%%%%   %     %     % %%%   %%%%%%%%%       %
%%% %%% %%% %%%%%%%%%%%%%%%%%%%%% %%%%%%%%% % % %%%%%%%%%%%%%%%%%%%%%%%%%%%%%%%%%%% %%%%%%%%% %%%%%%%
%     %   %     %%%   %%%   %%%%%   %   %%% % % %%%%%%%%% %%%%%%% %%%%%%%   %%% %         %%% %%%   %
% %%% %%%%%%%%% %%% % %%% % %%%%%%% % % %%%%% %%%%%%%%%%% %%%%%%% %%%%%%% %%%%% % %%%%%%%%%%% %%%%% %
%   %           %%% %     % %%%%%%%   % %   %     %%%                   %     %     %%%%%%%%% % %%% %
%%% %%%%%%% %%%%%%%%%%% %%% %%%%%%% %%% % % %%%%% %%% %%%%%%%%% % %%%%%%% %%% % %%% %%%%%%%%% % %%% %
%%%     %%% %%%%%     % %%% %%%%%%% %%%   %     %       %%%%%%% %         %%%   %%% %%%%% %%% %     %
%%% %%% %%% %%%%%%% % % %%% %%%%%%%%%%% %%%%%%% %%% %%%%%%%%%%% %%%%%%%%% %%%%%%%%%%%%%%% %%% %%%%% %
%   %%% %%% %   %%% %   % % %%%       % %%%%%%% %%%   %%%           %%%%% %%%%%%% %%% %       %%%   %
%%% %%% %%%%% % %%% %%%%% % %%% %%% % % %%%%%%% %%%%%%%%% %%%%% %%%%%%%%%%%%%%%%% %%% % %%%%% %%% %%%
%%% %%%   %%% %     %%%   % %   %   % % %%%%%%%   %%%%%   %%%%% %%%%%%%%%%%%%%%%% %%%     %%%     %%%
%%% %%%%%%%%% %%%%%%%%% %%% %%%%% %%% %%%%%%%%%%% %%%%% %%%%%%% %%%%%%%%%%%%%%%%% %%%%% %%%%%%%%% %%%
%   %%%%%%%   %%%%%%%             %   %     %       %%%     %%% % %%%%%%%%%%%%%   %%%%% %%% %%%     %
% %%%%%%%%%%% %%%%%%%%% %%% %%%%%%%%% % %%% %%% %%%%%%%%% %%%%% % %%%%%%%%%%%%% %%%%%%% %%% %%% %%% %
%   %%%       % %%%%%%% %%% %%%%% %%% %   % %%% %%%%%   % %%%%%   % %%% %%%%%   %%%     %   %%% %%% %
% %%%%% % %%% % %%%%%%%%%%%%%%%%% %%% %%% % %%% %%%%% %%% %%%%%%% % %%% %%%%% %%%%%%% %%% % %%%%%%%%%
% %%%   % %%%   %%%%%%%%% %%% %%%         %     %         %%%%%       %   %%%   %%%%%     %   %%%%%%%
% %%%%%%% %%%%%%%%%%%%%%% %%% %%% %%%%%%% %%% %%% %%%%%%%%%%%%%%%%%%% %%% %%% % %%%%%%%%%%%%% %%%%%%%
% % %%%%% %%%     %%%%%         % % %%%   %%% %%% %     %%%%% %%%%%   %   %%% %   %%%       %       %
% % %%%%% %%% %%% %%%%% %%%%% % % % %%% %%%%%%%%% % %%%%%%%%% %%%%%%% % % %%% %%% %%% %%% % %%%%% %%%
% %     %   % %%% %       %%% %     %%%     %%% %   %     %   %%% %%%   % %%%   %     %   %   %%% %%%
% %%% % %%% % %%% %%% %%%%%%%%%%%%%%%%%%%%% %%% %%% % %%% % % %%% %%%%%%% %%% %%% %%%%% %%%%% %%% %%%
%   % % %%%   %%%   % %     %   %%%%%   %%% %%%     %   %   %       %%%   %%% %%% %%%   %%%%%   %   %
%%% %%% %%%%% %%%%% % % % %%% % %%%%% % %%% %%%%%%% % %%% %%% % %%%%%%%%%%%%%%%%%%%%% % %%%%%%% %%% %
%%%     %   % %     % % %     %     % %   %   %%%%% % %%% %%% % %%%%%           %%%   %     %%%   % %
%%%%%%%%% % %%% %%% %%% %%%%% %%%%% %%%%% %%% %%%%%%% %%%%%%% % %%%%% %%%%%%%%% %%% % %%%%%%%%% %%% %
%         %   % %   %%% % %%%     % %%%     % %%%%%%% % %%%   % %%%     %%%%%%% %   %     %%%   %%% %
% %%%%%%%%%%% % %%%%%%% % %%% %%%%% %%% %%% % %%%%%%% % %%%%% %%%%% %%%%%%%%%%% %%% %%%%% %%%%%%%%% %
% %%%%% %%%   %   %%% % % %%% %     %%% %   % %%%%%     %%%%%     % %%%%%       %%% %   %   %%%     %
% %%%%% %%% %%%%% %%% % % %%%%% %%%%%%% % %%% %%%%% %%%%%%%%%%%%% % %%%%%%% % %%%%% % %%% %%%%% %%%%%
% %       %   %%% %         %%% %   %%% %   % %   % % %%%   %%% %   %%%%%%% %     %   %%%   %%%   % %
% % %%%%%%% %%%%% % %%%%%%%%%%% %%% %%% %%% % %%% % % %%%%% %%% %%%%%%%%%%%%% %%% %%% %%%%% %%%%% % %
% % %%%     %%%   % % %%%%%%%   %%%       % %     %       %               %%%   % %%%   %%%       % %
% % %%% %%% %%% %%% % %%%%%%%%% %%%%%%%%% %%%%% %%% %%%%% %%% %%%%%%%%%%%%%%%%%%% %%% %%%%%%%%%%%%% %
% %     %%%     %%% %       %   %%%%%     %%%%% %   %%%       %   %%%       %%%%% %%% %%%%%         %
% %%%%%%%%%%%%%%%%% % %%%%%%% %%%%%%% %%%%%%%%% % %%%%%%% %%% % % %%% %%% %%%%%%% %%% %%%%%%%%%%%%% %
%     %%% %%%%%%% %   %%%%%%% %%% %%%       %   % %   %%% %%% % %     %%% %%%   % %%%   %%%   %%%%% %
% %%% %%% %%%%%%% %%% %%%%%%% %%% %%%%% %%% % %%% % %%%%%%%%%%% %%% %%%%% %%% % % %%%%% %%% % %%%%% %
% %   %%%     %   %%%   %   % %%%   %%% %%%     %   %%% %S      %%% %%%   %%% %   %%%   %   % %     %
% % %%%%%%% %%% % %%%%% %%% % %%% %%%%%%%%%%%%%%%%% %%% %%%%%%%%%%%%%%% %%%%% % %%%%% %%% % % %%%%% %
% %     %%%     %     % %   %     %%% %     %%%%%   %%%   %%% %%%%%%% % % %%% % %%%   %   % %   %%% %
% %%%%% %%%%%%% %%% %%% % % %%% %%%%% % %%% %%%%% %%%%% % %%% %%%%%%% % % %%% %%%%% %%%%%%% %%% %%% %
% %%%%% %%%%%%% %%%     % % %   %%% %   %   %%%   %%%   %       %%%   %       %%%%% %%%%%%%   %   % %
% %%%%% %%%%%%% %%%%% %%% %%% % %%% % %%% % %%% %%%%%%% %%%%% %%%%% %%%%%%%%%%%%%%% %%%%%%% % %%% % %
% %%%   %%% %%%   %%%     %   %     % %%% %   % %   %%% %   % %%%         %%%%%%% % %     % %   %   %
%%%%% % %%% %%%%%%%%%%% %%% %%%%% %%% %%% % %%% % %%%%% % % % %%% %%% % %%%%%%%%% % % %%% %%% % %%% %
%%%%% %       %%%%%%% % %%% %%%   %   %   % %   % %%%   % %     % %%% % %%%%%%%%%     %%% %%% %   % %
%%%%% %%% %%%%%%%%%%% % %%% %%%%%%% %%% %%%%% %%% %%% %%% %%%%%%% %%%%% %%%%%%%%%%%%%%%%% %%%%%%% % %
% %     % %%%%%%%     % %%%         %%%   %%% %       %%% %%%     % %%%   %%%%%%%%%%%%% %         % %
% % %%%%% %%%%%%% %%%%% %%%%%%%%%%%%%%%%% %%% %%%%% % %%%%%%% %%%%% %%%%% %%%%%%%%%%%%% %%% %%%%%%% %
%   %%%   %%%%%     %%% %%%   %       %%%   % %%%%% %       %   %   %%%%%   %%%         %%% %%%%%%% %
%%% %%% %%%%%%% %%% %%% %%%%% % %%% % %%%%% % %%%%% %%%%%%% %%% %%% %%%%% %%%%%%%%%%% % %%% %%%%%%%%%
%%% %%%     %%% %%% %   %%%%%   %%% %   %%% % % %     %%%%%       %   %%%     %%%%%%% %   % %%%%% %%%
%%% %%%%%%% %%% %%% % %%%%%%%%%%%%% %%% %%% % % % %%%%%%%%%%% %%% %%% %%%%%%% %%%%%%%%%%% % %%%%% %%%
%   %%%     %   %%%   %%%           %%% %%%   % % %%%%%%%%%%% %%% %%%     %%% %%%   %%%%% %         %
%%%%%%% %%%%% %%%%% %%%%% %%% %%%%% %%%%%%%%%%% % %%%%%%%%%%%%%%% %%% %%%%%%% %%% %%%%%%% %%%%%%%%% %
%%%%%%%       %%%   %%%   %%% %   %   %%%%% %%%   %%% %%%   %%%   %%% %%%%%%% %%% %%%   %         % %
%%%%%%% %%%%%%%%% %%%%%%%%%%% % %%%%% %%%%% %%%%% %%% %%% % %%% %%%%% %%%%%%% %%% %%% % % %%%%% % % %
% %         %%%%% %   %%%     %   %   %%%     %%% %%%     %   %   %%%   %%% %     %%% % % % %%% %   %
% % %%%%%%% %%%%% %%% %%% %%% %%% % %%%%% %%%%%%%%%%%%% %%%%% %%% %%% %%%%% %%% %%%%% %%% % %%%%%%%%%
% % %%%     %%% %       % %   %%%     %%% %%%%% %%% %%%   %%%   %   % %%%%% %%%   %%% %%%   % %%%   %
% % %%% %%% %%% %%% %%% % % %%%%%%%%% %%% %%%%% %%% %%% %%%%% %%%%% % %%%%% %%%%% %%% %%%%% % %%% %%%
%   %%% %%% %%%     %%%   % %%%%%%%%%     %         %%% %%% %                   %       %%%     % %%%
% %%%%% %%% %%% %%% %%%%%%% %%%%%%%%% %%% % %%% %%% %%%%%%% % %%%%%%%%%%% %%%%% %%% % %%%%%%%%% % %%%
% %%%   %%% %%% %%% %%%%%     %%%%%%% %%% % %%% %%%   %%%     %%%%%%%     %%%%% %%% % %       %     %
% %%%%% %%%%%%%%%%% %%%%%%% %%%%%%%%%%%%% % %%%%%%%%%%%%% %%%%%%%%%%% %%%%%%%%%%%%% % % %%%%% % %%% %
%   %%% %%%%%%%%%%%     %%% %%%%%%%%%%%     %%%%%%%%%%%%%   %%%       %%%%%%%%%%%   %     %%%   %%% %
%%%%%%%%%%%%%%%%%%%%%%%%%%%%%%%%%%%%%%%%%%%%%%%%%%%%%%%%%%%%%%%%%%%%%%%%%%%%%%%%%%%%%%%%%%%%%%%%%%%%%
