%%%%%%%%%%%%%%%%%%%%%%%%%%%%%%%%%%%%%%%%%%%%%%%%%%%%%%%%%%%%%%%%%%%%%%%%%%%%%%%%%%%%%%%%%%%%%%%%%%%%%
%%%           %%%%%%%%%%%   %%%                 %   %%%   %%%   %%%%% %%%     %%% %%%   %%%         %
%%% %%%%%%% %%%%%%%%%%%%%%% %%% %%%%%%%%%%%%%%% % % %%% % %%% %%%%%%% %%%%%%% %%% %%%%% %%% %%% %%%%%
%       %%%     %%%%%%% %%%     %     %%%%%%% %   %     %                 %%%       %%% %%% %%% %%%%%
%%%%%%% %%%%%%% %%%%%%% %%%%%%% % %%% %%%%%%% %%%%%%%%% %%% %%%%% %%% %%% %%%%% %%%%%%% %%% %%%%%%%%%
%%%   %     %%%   %%%   % %%%%%   %%% %%%       %%%%%%% %%%   %%% %   %%%   %%% %%%%%       %%%%%%%%%
%%% % % %%%%%%% % %%% % % %%%%%%%%%%% %%%%% % %%%%%%%%%%%%% %%%%%%% %%%%%%% %%% %%%%% %%%%% %%%%%%%%%
%%% %   %%%     %   % %     %%%     % % %%% % %%%%%   %%%   %   %%% %   %%% %   %%%   %%%%%   %%%%% %
%%% %%%%%%% %%%%%%% % %%%%%%%%%%% % % % %%% %%%%%%%%% %%% %%% % %%% % % %%% % %%%%% %%%%%%% % %%%%% %
%   %%%%% %   %%%%%   %%%%%%%%%%% % %   %   %%% %       % %   % %%%   %   %   %%%   %%%     % %     %
%%% %%%%% % % %%%%%%%%%%%%%%%%%%% %%%%% % % %%% % % %%%%% % %%% %%%%%%%%% %%%%%%%%% %%%%% %%% % %%% %
%%% %%%%%   %     %%%%%   %%%     %%% %   % %%%   %       %   %           %%%%%%%%%   %   %   % %%% %
%%% %%%%%%%%% %%% %%%%% %%%%% %%% %%% %%% %%%%%%%%% %%%%%%%%% %%%%%%%%%%% %%%%%%%%% %%% % %%% % %%%%%
%       %%%%% %%%       %%%%% %   %   %%% %%%%%%%%% %%%%%%%%%   %%%%% %%%     %%%   %%% % %%%     %%%
%%%%% %%%%%%%%%%%%% %%% %%%%%%% %%% % %%% %%%%%%%%%%%%%%%%%%%%% %%%%% %%%%%%% %%%%% %%% %%%%%%%%% %%%
%%%%% %%%%%%%%% %%% %%% %%%%%%%     %   %   %%%   %%%     % %%% %%%%%       %     %   % %%%%% %%%   %
%%%%% %%%%%%%%% %%%%%%% %%%%%%%%% %%% % %%% %%%%% %%% %%% % %%% %%%%% %%% %%%%%%% %%%%% %%%%% %%%%% %
%%%     %%%     %%%%%%%   %%%%%%% %   %   % %%%%%     % %   %%%   %     % %%% %%% %%%%% %%%     %%% %
%%% %%%%%%%%% % %%%%%%%%% %%%%%%%%% %%%%% % %%%%%%% %%% %%% %%%%% %%%%% % %%% %%% %%%%% %%%%%%% %%% %
%   %%%%%     %   %   %%%           %%%%% %   %%%%%   %   %       %%%%% % %%%   % %     %       %%% %
%%% %%%%% %%%%%%% %%% %%%%%%% % %%%%%%%%%%%%% %%%%%%% % %%% %%%%% %%%%%%% %%% %%% % %%%%%%% %%% %%% %
%%% %%%   %   %%%             % %%%%%%%         %%%%% %     %%%%% %%% %%%     %%%   %%% %%%   % %   %
%%% %%%%% %%% %%%%%%% %%%%%%% %%%%%%%%% %%%%%%% %%%%% % %%%%%%%%%%%%% %%%%%%% %%%%%%%%% %%%%% %%% %%%
%     %%%   %     %%% %%%   % %%%     %   %%%%%     % %     %%% %%%                       %%% %%% %%%
% %%%%%%% % % % %%%%%%%%% % % %%%%%%% %%% %%%%%%%%%%% %%%%% %%% %%%%% % %%% %%%%% %%%%%%% %%% %%% %%%
%   %%%%% % % %     %%%   %     %%%%% %       %%%%%%% %%%     %   %%% % %%% %%%%% %%%%%     %   %   %
%%%%%%%%%%% % %%%%% %%% %%%%%%%%%%%%% % %%%%% %%%%%%% %%%%%%% % % %%%%% %%%%%%%%% %%%%%%% %%% % %%% %
%%%%%   %%% % %%%   % % %%%%%%%%%%%       %%%   %%%       %     %   %%%     % %%% % %%%%% %   %     %
%%%%%%% %%% %%%%% % % % %%%%%%%%%%% %%%%% %%%%%%%%% %%%%% %%%%%%% %%%%% %%% % %%% % %%%%%%% %%%%%%%%%
%   %%%     %%%   % % %   %%%%%%% % %%%%%   %%%%%     %%%   %     %%% % % % %   %   %%% %%% %%%%%%%%%
% %%%%% %%%%%%%%% % % %%% %%%%%%% % %%%%%%% %%%%%%% %%%%%%% %%%%%%%%% % % % % %%%%% %%% %%% %%%%%%%%%
% %     %   %     %   %       %     %%% %%% %     % %%%%%%% %%%%%%%%%   % % %     %     %%%   %%% %%%
% % % %%% % %%% %%%%%%% %%%%%%% %%%%%%% %%% % %%% %%%%%%%%% %%%%%%%%% %%% % %%%%% % %%% %%% %%%%% %%%
%   % %%% % %%%   %%%     %%%%%         %%% % %%%   % %%%   %%%   %%%   % %   %%%   %%% %%% %%%%%   %
% %%% %%% % %%%%% %%% %%%%%%%%% %%% %%% %%%%% %%%%% % %%%%% %%% % %%%%% % %%% %%% %%%%%%%%% %%%%% % %
% %%%     %   %%%       %%%     %%% %%% %     %%%%% %   %%%     %     % % %%%   % %%%%%%% % %%%%% % %
% %%% %%%%% %%%%% %%%%%%%%% %%%%%%%%%%% % %%% %%%%% %%% %%% %%%%% %%% % % %%%%% % %%%%%%% % %%%%% % %
% %%%   %   %%%%% %%%%%%%%% %%%   %%%   % %   % %%%     %%% %%%%% %%% %     %   %   %%%   %       % %
%%%%%%% % % %%%%%%%%%%%%%%% %%% %%%%%%%%% %%% % %%%%% %%%%% %%%%%%%%% %%% %%% %%%%% %%%%% %%%%% %%% %
%%% %%% % % %%%         %%% %%% %%% %%%%% %%%   %%%%% %%%   % %%%%%   %   %   %%%%% %%%   %     %%% %
%%% %%%%% %%%%% %%%%%%% %%% %%% %%% %%%%% %%% %%%%%%% %%% %%% %%%%%%% %%%%% %%%%%%% %%% % % %%%%%%% %
%%%   %%% %         %%%     %%% %%%     % %   %%%       %     %%%     %%%%% %%%%% %     % % % %%%   %
%%% %%%%% % %%%%% %%%%% %%%%%%% %%% %%% % %%% %%% %%%%% %%%%%%%%% %%%%%%%%% %%%%% %%% %%%%% % %%%%%%%
%%%   %%% % % %%% %%%%% %%%%%     %   %   %%% %%% %%%%% %%%%%%%%% %%% %%%   %%%%% %%% %%%%%     %%%%%
%%% % %%% % % %%%%%%%%%%%%%%%%% % %%% %%%%%%%%%%%%%%%%% %%%%%%%%% %%% %%% %%%%%%% %%% %%%%%%%%% %%%%%
%   % %%%   %   %%%   %%%   %%% % %%% %%%%% %%%%%%%%%   %         %         %%%   %%%   %%%%%%% %   %
% %%% %%% %%%%% %%%%% %%% % %%%%% %%% %%%%% %%%%%%%%%%% % %%%%%%%%%%% %%%%% %%% % %%% %%%%%%%%% % % %
% %%%         %  !  %     % % %%%   %   %           %%%   %%%%% %%%%% %%%   %   %     %%%%%       % %
%%%%% %%%%%%% % %%% %%% %%% % %%% % %%% %%%%% %%%%%%%%%%%%%%%%% %%%%%%%%% %%%%% %%%%%%%%%%%%% %%%%% %
%%% % %%%%%     %%%     %%% %     %   % %%%%%   %%%%% %%% %%%   %%% %%%%%     % %%%     %%%%%   %%% %
%%% % %%%%%%%%%%%%%%%%%%%%% % % %%% %%% %%%%%%% %%%%% %%% %%% % %%% %%%%%%%%% %%%%% %%% %%%%%%% %%% %
%%% %   % %%%%% %%%   %%%     % %%% %%% % %%%%%               %           %   %%% %   % %%%%%%% %%% %
%%% %%% % %%%%% %%% % %%%%%%% %%%%%%%%% % %%%%% %%% %%%%%%%%% %%%%% %%% % % %%%%% %%% % %%%%%%% %%%%%
%%%       % %%%     %   %%%   %%% %%%%% % %   % %%% %%% %%%%% %%%%% %%% %   %         % %%%%%%% % %%%
%%%%%%%%% % %%% %%% % %%%%% %%%%% %%%%% % % % % %%%%%%% %%%%%%%%%%%%%%% %%%%% %%%%%%%%% %%%%%%% % %%%
%%%%%%%%%   %%% %%% % %     %%%%% %%%   %   %   % %%%     % %%%%% %%%%% %%%   %     %   %%%%%%%     %
%%%%%%%%%%% %%%%%%% %%% %%%%%%%%% %%% %%% %%%%%%% %%% %%% % %%%%% %%%%% %%% %%% % %%% %%%%%%%%%%% %%%
%%%%%%%%%%%   %%% %       %%%%%%%     %%%     %%%     %%%   %%%           % %%% % %%% %%%%%   %   %%%
%%%%%%%%%%% %%%%% % %%% %%%%%%%%% %%%%%%%%%%% %%%%%%% %%%%% %%%%% % %%%%%%% %%% %%%%% %%%%%%% % %%%%%
%%%%%%%%%%% %%%     %%% %%%%%%% %     %%%%% %           %%%   %%% % %%%         %%%     %%%   %     %
%%%%%%%%%%%%%%%%%%% %%%%%%%%%%% %%%%% %%%%% %%% %%% %%% %%%%% %%% % %%% %%%%%%% %%% % %%%%% %%% %%%%%
%%%%%%%   %%%%%%%%%   %%%%%%%     %   %         %%% %%% %%%     % % %%%     %%% %%% % %%%%%   % %%%%%
%%%%%%% % %%%%%%%%% %%%%%%%%% % %%% %%% %%%%%%% %%% %%% %%% %%% % %%%%%%%%% %%%%%%%%% %%%%% % % %%%%%
%%%%%%% %     %%% % %%%       % %%% %   %   %%% %%% %%% %%% %%% %           %   % %%%   %%% %   %%%%%
%%%%%%% %%% %%%%% % %%%%% % %%% %%% %%%%% % %%%%%%%%%%% %%%%%%% %%%%%%%%%%%%% % % %%% %%%%%%%%% %%%%%
%%%%%   %%%         %%%%% % %%% %%%       %   %%%%%%%%% % %%%       %%%%%%%   %   %   %%%%%%%%%   %%%
%%%%% %%%%% %%%%%%%%%%%%% % %%%%%%%%%%%%%%% %%%%%%%%%%% % %%%%%%%%% %%%%%%% %%%%% % %%%%%%%%%%% %%%%%
%%%%% %%%                 % %%%%% %%%%%     %%%%%%%%%   %   %%%%%%%   %%%%% %%%%%   %%%%%%%     %%% %
%%%%%%%%%%%%%%%%%%%%%%%%%%% %%%%% %%%%% %%%%%%%%%%%%% %%% %%%%%%%%%%% %%%%% %%%%%%% %%%%%%% %%%%%%% %
%%%%%%%%%%%   %%%%% %%%   % % %   %%%   %%%%%   %%% %     %%%         %%% %   %%%%%     %%% % %%%%% %
%%%%%%%%%%% %%%%%%% %%%%% % % % % %%%%% %%%%% %%%%% %%% %%%%% %%%%%%%%%%% %%% %%%%%%%%%%%%% % %%%%% %
%%%%%%%%%%% %%%       %%%   %   % %%%%%       %%%%%     %%%     %%%%%%% %   %   %%%%%%%   %         %
%%%%%%%%%%% %%% %%% %%%%%%% %%%%% %%%%% %%% %%%%%%%%%%% %%%%%%% %%%%%%% % % %%% %%%%%%% % %%%%% %%%%%
%%%%%%%%%%%   % %%%     %%% %%%%% %%%   %   %%%   %%%%%   %%%   %%%       %   %         %     % %%%%%
%%%%%%%%%%% % % %%%%%%% %%% %%%%% %%%%% %%% %%% % %%%%%%%%%%%%% %%%%%%%%% %%% %%%%%%%%%%% %%%%% %%%%%
%%%%%%%%%%% % % %   %%%     %%%     %%%   % %%% % %%% %%%%% %%%     %%%%% %     %%% %%% %   %   %   %
%%%%%%%%%%%%% % % %%%%%%%%%%%%% % %%%%%%% %%%%% %%%%% %%%%% %%%%%%% %%%%%%% % %%%%% %%% %%% % %%%%% %
%%%   %%%     % % %%%%%%%%%     % %%%%% %   %   %     %   %         %%% %%% % %%%         %   %     %
%%%%% %%% % %%% % %%%%%%%%%%% %%% %%%%% %%% % % % %%% % % % %%% %%% %%% %%% % %%%%%%%%% % %%%%% %%% %
%     %%% % %%%             % %%% %%%%% %%%   %   %%% % % % %%% %%% %       % % %%%%%%% % %%%%% %%% %
%%% %%%%% %%%%%%%%%%%%%%%%% % %%% %%%%% %%%%% %%%%%%% % % %%%%%%%%% % %%%%%%% % %%%%%%%%% %%%%% %%% %
%%% %       %%%%%%%%%%%%%   % %   %%%   %%%%%     %%%   % %%%%%%% %   %     % %                 %   %
%%% % %%% % %%%%%%%%%%%%% %%% % %%%%% %%%%%%% %%% %%%%%%% %%%%%%% %%%%% %%% % % %%% % %%%%% %%%%% %%%
%     %%% %   %%%   %%% % %%% %   %%%   %%%   %%%     %%%   %%%%% %     %%% % % %%% % %%%%% %%%     %
%%% %%%%% %%% %%% %%%%% % %%% %%% %%%%% %%%%%%%%%%%%%%%%% % %%%%% % %%%%%%% % % %%% %%%%%%%%%%%%%%%%%
%%% %%%   %%%     %%%     %%%   % %%%   %%%     %%%%%%%   % %%%%%   %%%%%%% % % %%%       %%%%%%%%%%%
%%%%%%% %%%%%%% %%%%% %%%%%%%%%%% %%% % %%% %%% %%%%%%% %%%%%%%%% %%%%%%%%% % %%%%%%% %%% %%%%%%%%%%%
% %%%   %   %%%     % %   %%%%%     % % %   %%%         %%%%%     %%%   %%% %   %%%%%   % %%%%%%%%%%%
% %%% %%% %%%%% %%% % % %%%%%%% %%% % %%% %%%%%%%%%%%%% %%%%%%% %%%%% % %%% %%% %%%%%%% % %%%%%%%%%%%
%     %%% %%%   % %   %   %%%     %   %%% %       %%%%%   %%%%%   %   % %%% %     %%%   %   %%%%%%%%%
% %%%%%%% %%%%% % %%%%% % %%% %%% %%% %%% % %%%%% %%%%%%%%%%%%%%% % %%% %%% % %%% %%% %%%%% %%%%%%%%%
% %%%%%   %%%%%     %%% % %%% %%% %%% %%%     %%%     %%%%%   %%%   %%% %%%   %%%     %   %   %%%%%%%
% %%%%%%% %%%%%%%%% %%%%% %%%%%%% %%% %%%%% %%%%%%%%% %%%%% %%%%%%%%%%% %%%%% %%%%%%%%%%% %%% %%%%%%%
% %%%     %%%   %%% %           % %%% % %%% %     %%% %     %%%   %%%   % %%%   %%%         % %%%%%%%
% %%%%% %%%%%%% %%% %%% %%%%%%% % %%% % %%%%% %%% %%% % % %%%%%%% %%%%% % %%%%% %%%%% %%% %%% %%%%%%%
%       %%%%%%%         %%%%%   % %%% %   %   %%%     % %   %%%%%   %%%     %%%   %%% %   %   %%%%%%%
%%% %%% %%%%%%%%% %%%%% %%%%%%% % %%% % %%% %%%%%%%%%%% %%% %%%%% %%%%% %%%%%%% %%%%% %%%%% %%%%%%%%%
%   %%% %     %%%   %%% %%%%%%%   %     %%%       %%%%% %%%   %%%     % %%%%%   %%%         %%%%%%%%%
% %%%%% % %%%%%%% %%%%%%%%%%%%%%% %%%%% %%% %%% % %%%%% %%% %%%%% %%% % %%%%%%% %%% %%% %%%%%%%%%%%%%
% %%%%%   %%%%%   %%%%%%%%%%%%%   %%%   %%% %%% %S%     %%%       %%%       %%% %%% %%% %%%%%%%%%%%%%
%%%%%%%%%%%%%%%%%%%%%%%%%%%%%%%%%%%%%%%%%%%%%%%%%%%%%%%%%%%%%%%%%%%%%%%%%%%%%%%%%%%%%%%%%%%%%%%%%%%%%
