%%%%%%%%%%%%%%%%%%%%%%%%%%%%%%%%%%%%%%%%%%%%%%%%%%%%%%%%%%%%%%%%%%%%%%%%%%%%%%%%%%%%%%%%%%%%%%%%%%%%%
%     %%% %%%       %%%     %       %%%%%%%%%%%%%%%%%%%%%%%       %%%%%       %       %%%       %%% %
% %%% %%% %%% %%%%% %%% %%% % %%%%%%%%%%%%%%%%%%%%%%%%%%%%% % %%%%%%%%% %%%%% % % %%%%%%% %%%%% %%% %
% %%%       % %         %%%   %%%%%   %%%%%%%%%%%%%%%%%%% % %   %%%%%   %%%     % %%%%%%%   %       %
% %%%%%%% % %%% %%%%%%% %%%%%%%%%%% % %%%%%%%%%%%%%%%%%%% % %%% %%%%%%% %%%%%%%%% %%%%%%%%%%% % %%% %
%   %     %   % %   %%% % %%%%%   % %   %%%%%%%%%%%%%%%     %%%   %%%%%   %%%%%         %%%   % %%% %
%%%%% % %%%%% % %%% %%% % %%%%% %%% %%% %%%%%%%%%%%%%%%%% %%%%% % %%%%%%% %%%%%%%%%%%%%%%%% %%%%%%%%%
%%%%% % %%%     %%%         %%%     %%% %%%%%%%%%%%%%%%%% %%%   %     %%%   %       %%%%%%% %%%%%%%%%
%%%%% % %%%%%%%%%%% %%%%%%% %%%%% %%%%% %%%%%%%%%%%%%%%%%%%%%%%%% %%%%%%% %%% %%% % %%%%%%% %%%%%%%%%
%%%   % %%%%%%%       %%%   % %%% %%%%%     %%%%%%%%%%% %%% %%%%% %   %%%     %%% %   %         %%%%%
%%% % %%%%%%%%%%%%% %%%%% %%% %%% %%%%%%%%% %%%%%%%%%%% %%% %%%%% % % %%%%% %%%%%%% % % %%%%% %%%%%%%
%   % %%%%%   %%%%% %%%       %   %%% %%%   % %%%%%%%       %%%%%   %   %%% %%% %%% %   % %%% %%%%% %
% %%% %%%%%%% %%%%% %%%%%%% %%% %%%%% %%% %%% %%%%%%% %%% % %%%%%%%%% %%%%% %%% %%%%% %%% %%% %%%%% %
% %%%   %%%%% %%%     %%%%% %%% %%% %     %     %     %%% %     %%%%%   %%%       %%%     %%%       %
% %%% %%%%%%% %%%%%%%%%%%%%%%%% %%% % % %%% %%% % %%%%%%%%% % %%%%%%%%% %%% %%%%%%%%%%% %%%%% %%%%% %
%   % %%%     % %%%%%%%       % %%%   % %   % % % %%%%% %%% % %%%%%     %   %%%%%%%%%   %%%%% %%%   %
% %%% %%%%% % % %%%%%%% %%%%% % %%%%%%% %%% % % % %%%%% %%% % %%%%% %%% % %%%%%%%%%%%%%%%%%%% %%% %%%
% %%%   %%% %   %%%   % %%%%% %   %%%   %%%   %     %%% %   %       %%% %   % %%%%%%%%%%%       %   %
%%%%% % %%% %%%%%%% % % %%%%% %%% %%% %%%%%%%%%%%%%%%%% % %%%%%%% %%%%% %%% % %%%%%%%%%%%%% %%% %%% %
%%%   %     %%%%% % %   %%%       %%%   %     %%%%%%%     %   %%%     % %   %   %%%%%%%%%%% %   %   %
%%%%%%% %%% %%%%% % %%%%%%%%% %%% %%%%% % %%% %%%%%%% %%%%%%% %%%%%%% %%% %%% % %%%%%%%%%%%%% %%% %%%
% %%%%%   % %%%%% % %%%%% %%% %%% % %%%   % %   %%%%%   %%%     % %%%         % %%%%%%%%%     % %   %
% %%%%% %%% %%%%% % %%%%% %%%%%%% % %%%%%%% %%% %%%%%%% %%% %%% % %%%%%%%%%%%%% %%%%%%%%% %%%%% % %%%
%   %%% %     %%% %         %%% %             %     %%%     %%%     %%%%%%%%%%%   %%%%%%% %       %%%
%%% %%%%% %%%%%%% %%%%%%% %%%%% % %%%%%%% %%%%% %%% %%%%% %%%%% %%%%%%%%%%%%%%% %%%%%%%%% % %%%%%%%%%
%   %%%   %%%%%     % %%% %%%%%   %%%%%   %%%%%   % % %   %%%   %%%%%     %   % %%% %%%   %   %     %
% % %%% %%%%%%% %%% % %%% %%%%%%%%%%%%%%%%%%%%%%%%% % % %%%%%%% %%%%%%%%% % % % %%% %%%%% %%%%% %%% %
% % %%%     %   %     %%% %%% %%%%%%%%%           % %   %   %%%     %%%%%   %   %%%   %%%       %   %
% %%%%%%% % % %%%%%%%%%%% %%% %%%%%%%%% %%% %%%%% % %%% %%% %%%%%%% %%%%%%%%%%%%%%%%% %%% %%%%%%% %%%
%     %%% % %   %%%%%%%   %     %%%   %   % %%%%%   %%%       %%%%% %%% %%%%%%%     %       %%%%% %%%
%%% %%%%% % %%% %%%%%%% %%% %%%%%%%%% % % %%%%%%%%%%%%%%%%% %%%%%%%%%%% %%%%%%% %%% %%%%%%% %%%%% %%%
%%%   %%% %       %     %%% %%%%% %%%   % %%%   %%%%%       %%%%% %%%   %%%%%%% %%%       % %%%     %
%%%%% %%% %%%%%%% % %%%%%%% %%%%% %%%%%%% %%%%% %%%%% %%%%% %%%%% %%%%% %%%%%%% %%%%%%%%% %%%%%%% % %
%     %     %%%   %   %             %%%%%   %%%     %   %%%           %   %%%     %%%%%%%     %   % %
%%% %%% %%% %%% %%%%% % %%% %%%%%%% %%%%%%% %%% %%% %%%%%%%%%%%%%%%%% % % %%% %%% %%%%%%%%%%% % %%% %
%%%     %%% %%% %%%%% % %   %%% %   %%%   % %     %   %%% %%%     %%% % % %%% %%% %     %%%%% % %%% %
%%% %%%%%%% %%% %%%%% % %%% %%% % %%%%%%% % % %%%%%%% %%% %%% %%% %%% % % %%%%%%% %%% % %%%%% % %%% %
%   %%%%%%%   % %%%%%   %%% %%%           %   % %%%   %%%       % %   % %   %%%   %%% % %%%%% % %   %
%%% %%%%%%% % %%%%%%% %%%%% %%%%% %%%%%%%%%%% % %%% % %%%%% %%% %%% %%% %%%%%%%%% %%% %%%%%%% % %%%%%
%%%     %%% % %%%   % %%%   %%%%% %%%%%%%%%%%   %   % %%%%% %%%     %%% %%%       %   %%%%% % % %%%%%
%%%%%%% %%%%% %%% %%% %%% %%%%%%%%%%%%%%%%%%%%%%% %%%%%%%%%%%%% %%%%%%% %%% %%%%%%% % %%%%% % % %%%%%
% %%%%%   %       %%% %%%     %%%%%         %   %   %%%   %%%   %%%%%     % %%%%%%% %           %%%%%
% %%%%% %%% %%%%% %%% %%%%% %%%%%%%%% %%% % % % %%% %%% % %%%%% %%%%% %%%%% %%%%%%% %%%%%%%%%%% %%%%%
%   %   %%% %   % %%% %%%   %%% %%%%% %   %   %     %   %   %%%       %%%%%     %%%       %%%%%   %%%
% %%% %%%%% % %%% %%% %%%%%%%%% %%%%% % %%%%% %%%%%%%%%%% %%%%% %%%%%%%%%%%%% % %%%%%%% %%%%%%% %%%%%
%     %%%%% %       % % %%%%%%%   %%% % %     %%%   %%%%%     % %%%%%%%   %%% % %%%     %%% %%% %%%%%
% %%%%%%%%% %%%%% %%% % %%%%%%% %%%%%%% %%%%%%%%%%% %%%%%%%%% % %%%%%%% % %%% % %%%%%%% %%% %%%%%%%%%
%   %     %   %%% %%%     %%%   %%% %   %%%%%%%%%%% %%%%%%%%%     %%%%% %     % %%%%%%% %%%   %%%   %
%%% % %%% %%% %%% %%%%% %%%%%%% %%% % %%%%%%%%%%%%% %%%%%%%%% %%%%%%%%%%%%% %%%%%%%%%%% %%%%% %%%%% %
%   %   %   % %%% %%%%% %%% %%%     %     %%% %%%%%             %%%%%%%%%%% %%%%%%%   %   %   %     %
% %%%%% %%%%% %%%%%%%%% %%% %%% % %%%%%%% %%% %%%%%%%%%%% %%% %%%%%%%%%%%%% %%%%%%% %%%%% % % %%% %%%
% % %%%   %%%       %%%       % % %%%%%%% %%%   %%%%%   % %%% %%%%%         %     %     %   %   %   %
% % %%% % %%%%% %%% %%%%%%%%% % %%%%%%%%% %%% %%%%%%% % %%%%%%%%%%%%% %%%%%%%%%%% % % %%%%%%%%% %%% %
%   % % %   %%%   % %%% %%%   % %%%     %             %     %%%       %%% %%%%%%%   % %%%     %   % %
%%% % % % %%%%%%%%% %%% %%% %%% %%%%% %%%%%%%%%%% %%%%%%% %%%%%%%%% %%%%% %%%%%%%%%%% %%%%% % %%% % %
% % %   % %%% %%%%% %%%   %   %   %%%     %%% %%% %%%%%%%   %   %%% %     %       %     %%% % %%%   %
% % % %%% %%% %%%%% %%% %%%%% % % %%%%% %%%%% %%%%%%%%%%% % % % %%% %%% % %%% %%% % %%% %%%%% %%%%% %
%   % %%%     %   % %%% %%%%% % % %%%%% %%%%%   %%%     % %   %   % %   % %   %     %%%   %%%   %%% %
% %%% %%%%%%% % % % %%% %%%%% % % %%%%% %%%%% %%%%% %%% %%%%%%%%% % % %%% % %%%%%%% %%%%% %%%%% %%% %
%   %     %%%   % %         %   % %     %%%   %%%   % %           % % %%%   %%%%% % %%%%%   %%%   % %
%%% %%% %%%%%%%%% %%%%%%%%% %%%%% % % %%%%% % %%% %%% %%%%%%%%%%%%% % %%% %%%%%%% % %%%%% %%%%% %%% %
%%% %%% %%%%% %%%   %%%%%%%   %%% % % %%%   % %S  %     %%%%%       %   % %%%   %     %%% %%%       %
%%% %%% %%%%% %%% %%%%%%%%%%% %%% % %%%%% %%%%%%%%% %%%%%%%%%%% %%%%%%% %%%%%%% % %%% %%%%%%% %%% %%%
% % %%%       % %     %%% %%%     % %%% %       %%%             % %%%%%       % % %%%   %%%   %%% %%%
% % %%%%%%%%% % %%% % %%% %%%%%%%%% %%% % %%% %%%%%%%%%%% %%%%%%% %%%%%%%%%%% % % %%%%%%%%% %%%%% %%%
% % %     %%%   %   % %%% %%%%%%%%%   %   %%%        !    %%%%%%% %%%%%%%%%%% %     %%%%% % %%%   % %
% % % %%% %%%%%%% %%%%%%% %%%%%%%%%%% % %%%%%%% %%% %%% %%%%%%%%% %%%%%%%%%%% %%% %%%%%%% % %%%%% % %
% % % %%%         %%%%%%% %%%%%   %%%   %     %   % %%% %%%%%%%   %%%%%   %%% %%% %%%     %   %%%   %
% % % %%%%%%% %%%%%%%%%%% %%%%% % %%%%%%% %%% %%% %%%%% %%%%%%% %%%%%%% % %%% %%%%%%% %%% %%% %%%%% %
%     %%%%%%% %%%%%   %         %   %%%   %   %%% %%%%%   %%%   %       % %%% %%%%%   %%%   %   %%% %
%%%%%%%%%%%%% %%%%%%% % %%% %%% % %%%%% %%% %%%%% %%%%%%% %%%%% % %%%%%%% %%% %%%%%%% %%%%%%%%% %%%%%
%%%   %%%%%%%     %%%   %%% %%% %       %%%         %%%%% %%%   %   % %%%       %%%%%   %%%     %%%%%
%%% % %%%%%%% %%% %%%%%%%%%%%%% %%% %%% %%% %%% %%%%%%%%%%%%% %%%%% % %%% %%%%% %%%%% %%%%% %%%%%%%%%
%   %         %%%   %%%%% %%%%% %%% %%%   % %%% %%%%%%% %%% %   %%%   %%% %%%         %%%   %%%%%   %
%%% %%%%% %%%%%%%%% %%%%% %%%%% %%%%%%%%% % %%%%%%%%%%% %%% % % %%% %%%%%%%%% %%% %%%%%%% %%%%%%%%% %
%%%   %%%   %%%%%%%         %%%   %%%%%%% % % %%%%%%% %       % %%% %%% %     %%% %%%%% % %%%       %
%%%%%%%%%%% %%%%%%%%% %%%%% %%%%%%%%%%%%% % % %%%%%%% % %%% %%% %%% %%% % %%%%%%%%%%%%% % %%% %%%%% %
% %%%%%%%   %%% %%%%% %%%%%             % % %   %%%     %%% %%%   %     %   %%% %%%       %%% %%%%% %
% %%%%%%% %%%%% %%%%%%%%%%% %%%%%%%%%%% % % %%% %%% %%% %%%%%%%%% % %%%%%%% %%% %%%%%%% %%%%% %%%%%%%
%         %%%     %%%%%     %%%%%%%%% %   %     %%% %%% %%%%% %%%   %%%%%%%     %%%%%%% %       %%%%%
%%% %%%%%%%%% % % %%%%%%% %%%%%%%%%%% %%%%%%% %%%%%%%%% %%%%% %%%%%%%%%%%%%%%%% %%%%%%% % %%% % %%%%%
%%% %   %%%%% % %   %%%%% %%%         %%%%%%% %%%%%%% % %%%     %%%     %%%%% %         %   % %     %
%%% % %%%%%%%%% %%%%%%%%%%%%% %%%%% %%%%%%%%%%%%%%%%% % %%% %%% %%% % %%%%%%% %%%%%%%%%%%%% % %%%%% %
%%%   %%%       %%%%%%%%%%%   %     %%%     %%%   %%%     % % %     % %%%       %%%   %%%   %   %%% %
%%% %%%%% %%%%%%%%%%%%%%%%% %%% %%%%%%% %%%%%%%%% %%%%%%% % % % %%%%% %%%%% %%%%%%% %%%%%%%%%%% %%% %
% % %%%%% %%%     %%%%%%% %   % %%%%%%%     %%%   % %%%   %   % %%%%% % %%%     %%%       %%%%%   % %
% % %%%%% %%% %%% %%%%%%% % % %%%%%%%%% %%% %%% % % %%%%% %%%%% %%%%% % %%% %%% %%% %%% % %%%%%%% %%%
%   %%%   %%% %%%   %%%%%   %       %   % % %%% %     %%%   %%% % %%%   %%% %%%     %   %     %   %%%
%%%%%%%%% %%% %%%%% %%%%% %%%%%%%%% % %%% % %%% %%%%%%%%%%% %%% % %%% %%%%% %%%%%%%%% %%%%%%% % %%%%%
%%%%%%%%%     %%%%% %%%   %%%%%%%%%   %   %     %%%             % %   %%%   % %%%%% % %%% %%% %   %%%
%%%%%%%%% %%% %%%%% %%%%% %%%%%%%%%%%%%%% %%%%% %%% %%%%%%%%%%%%% % %%%%%%% % %%%%% % %%% %%% %%% %%%
%%%%%%%   %%%     %   %%%         %%%   %     % %     %%%%%   %%%   %%% %%% % %%%   %   %           %
%%%%%%%%% %%%%%%% %%% %%%%%%%%%%% %%% % %%% % % % %%% %%%%%%% %%% %%%%% %%% % %%% % %%% %%%%%%% %%% %
%%%%%%%%% %%%   %   %   %%%   %%%   % %     % % % %%%   %%%%%   %       %   %     % %   %%%%%   %%% %
%%%%%%%%%%%%% %%% %%% %%%%% % %%%%% % %%%%%%% % % %%%%% %%%%% %%%%%%%%% %%% %%% %%%%% %%%%%%%%%%%%% %
%%%%%%%%%%%       %%%       % %     %   %%%   % %   %%% %%%%%   %%%%%   %%%     %%%%% %%%%%%%%%%%%% %
%%%%%%%%%%%%% %%%%%%%%% %%% %%% %%%%% % %%% %%% % %%%%% %%%%% % %%%%% %%%%%%% %%%%%%% %%%%%%%%%%%%% %
%%%%%%%%%%%%% % %%% %%% %%%     %   % % %   %%%   %%%%% %%%%% %         %%%   %%%     %%%%%%%%%%%%% %
%%%%%%%%%%%%% % %%% %%% %%%%%%% % % %%% %%%%%%% %%%%%%%%%%%%% %%%%%%%%% %%%%%%%%% % %%%%%%%%%%%%%%% %
%%%%%%%%%%%%%   %%%         %%%   %     %%%%%         %%%         %%%%%           % %%%%%%%%%%%%%%% %
%%%%%%%%%%%%%%%%%%%%%%%%%%%%%%%%%%%%%%%%%%%%%%%%%%%%%%%%%%%%%%%%%%%%%%%%%%%%%%%%%%%%%%%%%%%%%%%%%%%%%
