%%%%%%%%%%%%%%%%%%%%%%%%%%%%%%%%%%%%%%%%%%%%%%%%%%%%%%%%%%%%%%%%%%%%%%%%%%%%%%%%%%%%%%%%%%%%%%%%%%%%%
%     %%%%%   %%% %       %%%%% %%%%%       %%% %%%%%%%%%%%%%%% %         %%%         %%%   %%%     %
% %%% %%%%% % %%% % %%% %%%%%%% %%%%% %%%%% %%% %%%%%%%%%%%%%%% % %%%%%%% %%% %%%%%%%%%%% % %%% %%% %
% %%% %%%%% % %     %%% %%% %   %%%%% %%%%%     %%%%%%%%%%%%%     %   %%%               % %   % %%% %
% %%%%%%%%%%% % %%% %%% %%% % % %%%%%%%%%%% %%%%%%%%%%%%%%%%% %%%%% %%%%%%%%%%%%%%%%%%% % %%% % %%% %
%   %%% %%%%%   %%% %%%       %             %%%%%%%%%%%%%%%         %%% %%%   %   %%% %     %   %   %
%%% %%% %%%%%%% %%%%%%% %%%%%%%%%%% %%%%%%% %%%%%%%%%%%%%%%%%%% %%%%%%% %%% % % % %%% %%%%% %%%%% % %
%%%       %%%%%   %%%   %     %%%%%     %%%   %%%%%%%%%%%%%%%   %%%%%   %%% %   % %   %%%%% %%%%% % %
%%% %%%%% %%%%%%% %%% %%% %%%%%%%%% %%% %%%%%%%%%%%%%%%%%%%%% %%%%%%%%% %%% % %%% % %%%%%%%%%%%%% %%%
%   % %     %%%   %%%     %%%%%%%%% %%% %%%%%%%%%%%%%%%%%%%   %%%%%       % % %%%   %%%       %%% %%%
%%% % % %%% %%%%%%%%%%% %%%%%%%%%%%%%%% %%%%%%%%%%%%%%%%%%% %%%%%%% %%%%% % % %%%%% %%%%% %%% %%% %%%
%%%   % %     %%%%%     %%% %%%%%       %     %%%%%%%%%%%   %%% %%% %%%%%   % %%%%% %     %       % %
%%%%% % %%%%% %%%%%%% %%%%% %%%%% %%%%%%% %%%%%%%%%%%%%%% %%%%% %%% %%%%% %%% %%%%%%% %%%%% %%%%% % %
%%%%% %   %%%   %%%%% %%%%%   %%% %%%%%     %%%%%%% %%%   %%%   %     %%% %%%     %%% % %%% % %%%   %
%%%%%%%%% %%%%%%%%%%% %%%%% % %%% %%%%%%%%% %%%%%%% %%% %%%%% % % %%%%%%% %%%%%%% %%% % %%% % %%%%% %
%%%%%%%%%   %     %%% %%%   %   % %%%%%%%%%   %%%     %       % %   %%%     %%%%% %%% %       %%%   %
%%%%%%%%% %%% % % %%% %%% %%%%% % %%%%%%%%%%% %%% %%% %%%%%%%%% %%% %%%%%%% %%%%%%%%% %%%%%%% %%%%% %
%%%%%%%       % % % % %       % %   %%%   %%%     %%%   %%% %   %   %%%%%%%     %%%   %%%%%%%   %%% %
%%%%%%%%%%%%%%% % % % %%% %%% %%%%% %%% %%%%% % %%%%% %%%%% % %%% % %%%%%%%%%%% %%%%% %%%%%%%%% %%% %
%%%%%%%%%%%%%%% %   %   % %%% %%% %     %S  % % %     %%%%%   %%% % %%%         %%%%%   %%%   % %%% %
%%%%%%%%%%%%%%% % %%%%% %%%%% %%% %%%%% %%% %%% % %%% %%%%% %%%%% % %%%%% %%%%%%%%%%% % %%% % %%%%% %
%%%%%%%   %     % %%%     %   %%%     %     %%% % %%% %%%   %%%   %   %%%         %%% %     %   %   %
%%%%%%%%% % %%% %%%%% %%% %%% %%%%% %%%%%%%%%%% %%%%% %%%%% %%% %%% %%%%%%%%%%%%% %%%%% %%% %%% %%%%%
%%%%% %%%   %%%       %%%   %   %%% %%%   %%%%%   %     %%%     %%% %%%   %%% %%%   %%% %%%   % %%%%%
%%%%% %%% %%%%% %%%%%%%%%%% %%% %%% %%%%% %%%%%%% %%%%%%%%%%% %%%%%%%%% % %%% %%% %%%%%%%%%%%%% %%%%%
% %%% %   %%%     %%%%%     %   %%%   %%%         %           %%% %%%   % %%%     %%%%%%% %%%%%   %%%
% %%% % %%%%%%%%%%%%%%% %%%%% %%%%%%% %%% %%% %%%%% %%%%%%% %%%%% %%% % %%%%% %%%%%%%%%%% %%%%%%% %%%
%     %     %%%%%%%%%   %%%%% %%%%%%%     %   %%%%%     %%% %%%   %%% %       %%%   %%%   %   %%% %%%
% %%% %%% %%%%%%%%%%% %%%%%%% %%%%%%% %%%%% %%%%%%%%%%% %%% %%%%% %%% %%%%%%%%%%%%% %%% % % %%%%% %%%
% %%%   % %%% %%%%%   %%%       %%%%%   %%% %%%%%%%     %%%   %%%     %         %%% %%% % % %%%     %
%%%%%%% % %%% %%%%% %%%%%%%%% % %%%%%%% %%% %%%%%%%%% %%%%%%% %%%%% %%% %%% %%% %%% %%% % % %%%%% %%%
%%%%%%%       %%%%% %%%     % %   %%%%% %   %%%%% %%% %%% %%%   %%% %%% %   %%% %   %   %       % %%%
%%%%%%% %%%%%%%%%%% %%% %%% %%%%% %%%%%%% %%%%%%% %%% %%% %%%%%%%%% %%%%% %%%%% %%% % %%% %%%%% % %%%
%   %%% % %%%%%%%%%     %         %%%%%%% %%% %         %       %   % %%%   %%% %   %   % %%%%%     %
% %%%%% % %%%%%%%%%%% %%% %%%%% %%%%%%%%% %%% % %%%%% %%% %%%%% %%% % %%%%% %%% % % %%% %%%%%%%%% %%%
% %%%%%     %%%%%%%   %%% %%%%% %%% %%%   %%%     %%% %%% %%%%% %%%   %   % % %   % %%%       %%% %%%
% %%%%%%% %%%%%%%%% %%%%%%%%%%%%%%% %%% %%%%% %%%%%%%%%%% %%%%% %%%%% % % % % % %%% %%%%%%%%% %%% %%%
%   %%%%% %%% %%%   %%% %%%   %%%               %%%       % %%% %     % % % %   %%% %%% %%%%% %   %%%
% % %%%%% %%% %%%%% %%% %%% % %%% %%%%%%%%%%%%%%%%% %%%%%%% %%% % %%% % % % % %%%%% %%% %%%%% %%%%%%%
% % %%%       %%%%% %%%   % %         %%%%%     %%% % %%%   %   % %%%   %   %   %%% %%% %%%   %%%%%%%
% % %%%%%%%%% %%%%%%%%% % % %%%%%%% %%%%%%% %%% %%% % %%% % % %%%%%%%%%%%%%%% %%%%%%%%% %%%%% %%%%%%%
% %   %%% %%% %   %%%   % % %   %%% %%%%%   %       %     % % %       %%%     %%% %%%%% %%%%%     %%%
% %%%%%%% %%% % % %%% %%%%% %%% %%%%%%%%%%% %%%%% %%%%% %%% % % %%%%% %%% %%%%%%% %%%%% %%%%% %%% %%%
% %       %%%   % %%%   %%% %%% %%%%%%%%%%% %%% % %%%%% %%% % % %%%     % %   %             % %%% % %
% % %%% % %%%%%%% %%%%% %%% %%% %%%%%%%%%%% %%% % %%%%% %%%%% % %%%%%%% % % % %%% %%%%%%%%%%% %%% % %
%   %%% %   %%% %   %%%     %       %%%%%   %     %%%     %%% %   %%% % %   % %%%   %%%%%%%%% %%% % %
%%%%%%% %%%%%%% % %%%%%%% %%%%%%% %%%%%%%%% %%%%% %%%%%%% %%% %%% %%% % %%%%% %%%%% %%%%%%%%% %%% % %
%%%%%   %%%%%     %%%%%%% %   %   %     %%% %%%%% %%%%%%% %%%   % %%%   %%%%%       % %%%   % %     %
%%%%% % %%%%% %%%%%%%%%%% % % % %%% %%% %%% %%%%% %%%%%%% %%%%% % %%%%% %%%%%%%%%%% % %%%%% % %%%%% %
%   % %     %   %   %%%%%   %   %%% %%%     %%%   %%%%%   %%%%% % % %%%     %%%%%%%   %%%   % %%%%% %
% %%% %%%%% %%% % % %%%%%%%%%%%%%%% %%%%%%%%%%%%% %%%%% % %%%%% % % %%%%% %%%%%%%%%%% %%% %%% %%%%% %
%     %%%%%   % % % %%% %%%%%%%%%         %%% %%%   %%% % %%%     %     % %%%     %%%   % %%% %   % %
% %%%%%%%%%%% % % % %%% %%%%%%%%%%% %%%%% %%% %%% %%%%% % %%%%%%%%%%% % % %%% % %%%%%%% % %%% %%% % %
% %%%%%%% %%%   % %             %%% % %%% %   %%% %%%   %   %%%%% %%% %     % % %%%%% %   %%% %%%   %
% %%%%%%% %%%%%%%%%%%%%%% %%% % %%% % %%% % %%%%%%%%% %%%%% %%%%% %%%%% %%% % % %%%%% % %%%%% %%%%% %
% %       %%%%%     %%%%% %%% % % %   % % % %%% %%%%%   %%%   %   %%%%% %%%   % %%%     %     %%%%% %
% %%% % %%%%%%% %%% %%%%%%%%% % % %%% % % % %%% %%%%%%% %%% % % % %%%%% %%%%%%% %%% %%%%% %%% %%%%% %
% %%% % %%%     %     %     % % %       % %       %%%%% %%% %   % %   %   %%%   %%% %     %%%   %%% %
% %%% % %%%%% %%%%%%% % %%% % % %%%%%%%%% %%%%%%% %%%%%%%%% %%%%%%% % %%% %%%%%%%%%%% %%%%%%%%% %%% %
% %%% % %%%   % %%%     %   % %     %     %%%%%%%     %%%%%   %%%   % %%% %%%%%%% %%% %%%%% %%% %%% %
% %%% % %%% %%% %%% %%%%% %%% %%%%% % %%%%%%%%%%% %%%%%%%%%%% %%% %%% %%% %%%%%%% %%% %%%%% %%%%%%%%%
%   % %     %%% %   %%%   %   %%%%% %   %%%   %%% %%%%%   %%%   % % %   %   %%%%%             %%%%%%%
%%% %%%%% %%%%% % %%%%%%% %%% %%%%% %%% %%% % %%% %%%%% %%%%% % % % %%% % %%%%%%% %%%%%%%%%%% %%%%%%%
%%%     % %%%   % %   %%%     % %   %   %   %     %%%%% %%%   %       %   %%%%% % %       %%%   %%%%%
%%%%%%% % %%%%% % % % %%%%% %%% % %%% % %%% %%%%% %%%%% %%% %%%%%%%%% %%%%%%%%% % %%%%%%% %%% %%%%%%%
%%%     %   %%%     % %%%   %%%       % %%% %%%%%   %%%     %%%%%%%     % %       %%%%%%% %   %%%%%%%
%%% %%%%%%% %%% %%%%%%%%% %%%%%%%%%%%%%%%%% %%%%%%% %%%%% %%%%%%%%%%%%% % % %%% %%%%%%%%% % %%%%%%%%%
%   %   %%% %%% %%%%%%%%%   %%%%%%%%%%%%%   %   %%% %%%%% %%%%%   %%%   %   %%%           % %%%%%%%%%
% %%% % %%% %%%%%%%%%%%%%%% %%%%%%%%%%%%%%% % % %%%%%%%%%%%%%%% % %%% %%% %%%%%%% %%% %%%%% %%%%%%%%%
%     % %%% %%%%% %%%   %%%     %%%     %%%   %   %%% %%%%%%%%% %   %   % %%%   % %%% %%%%%   %%%%%%%
%%%%%%% %%% %%%%% %%%%% %%%%% %%%%%%% % %%%%% %%% %%% %%%%%%%%% %%%%%%% %%%%% % % %%%%%%%%%%% %%%%%%%
%%%%%       %%%     %%% %%% % %%%%%   %   %%% %%%       %%%%%%%   %%% %       % %   %%% %     %%%%%%%
%%%%% %%%%%%%%% %%% %%% %%% % %%%%% %%%%% %%%%%%% %%%%% %%%%%%%%% %%% %%%%%%%%% %%%%%%% % % %%%%%%%%%
%   % %%%%%%%     % %%% %%%   %%%%% %%%   %       %%%%%   %%%       %     %%%   %%%   %   % %%%%%%%%%
% %%% %%%%%%% %%% % %%% %%%%%%%%%%% %%% %%% %%%%%%%%%%%%% %%% %%%%%%% %%% %%% %%%%% % %%%%% %%%%%%%%%
% %%% %%%%% % %%% %     %%%%%%%     %%% %%% %%%%%%%   %%% %     %%%     %    !%%%   %     %   %%%%%%%
% %%% %%%%% % %%%%% %%%%%%%%%%% %%%%%%% %%% %%%%%%% %%%%% % %%% %%% %%%%%%%%%%%%%%% %%%%% %%% %%%%%%%
%       %%%   %%%%%   %%%%%%%%% %   % %   % %       %%% % % %%%   %   %%%%%     %%% %%%       %%%%%%%
%%% %%% %%%%%%%%%%%%% %%%%%%%%% % % % %%% % %%%%%%% %%% % %%%%%%% %%% %%%%% % % %%% %%%%%%% %%%%%%%%%
%%% %%% %%%%%%%   %%%           % %     %   %%%%%%%     %     %%%   %   %   % %       %%%   %%%%%%%%%
%%%%%%%%%%%%%%% %%%%%%% %%%%%%%%% % %%%%%%% %%%%%%%%% % %%% %%%%%%% %%% %%%%% %%%%%%%%%%%%% %%%%%%%%%
% %%%%%%%%%%%%% %       %%%   %   % %%%%%%%   %%%%%%% %     %%%%%%%   %     % %   %%%%%%%%%   %%%%%%%
% %%%%%%%%%%%%% % %%% %%%%% %%% % %%%%%%%%% %%%%%%%%%%%%%%% %%%%%%%%% %%%%% % %%% %%%%%%%%% %%%%%%%%%
% %%%%%%%%%   %   %%%     %     %     %%%   %%% %%%%%%%%%%%             %%%   %%% %   %%%   %%%%%%%%%
% %%%%%%%%%%% % %%%%%%%%% % %%%%%%%%% %%% %%%%% %%%%%%%%%%%%%%% %%%%%%%%%%%%% %%% % % %%% %%%%%%%%%%%
%   %%%%%%%%%           % %   % %%%%%     %%%%%       %   %%%%% %%%%%%%%% %%% %%%   %   % %%%%%%%%%%%
%%% %%%%%%%%% %%%%%%%%%%% %%% % %%%%%%%%%%%%%%% %%%%% %%% %%%%%%%%%%%%%%% %%% %%%%%%%%% % %%%%%%%%%%%
%%% %%% %%%%% %%%%%%%%%%% %%%       %%%         %%%%%     %%% %%%%%         %   %%%%%%%   %%%%%%%%%%%
%%% %%% %%%%% %%%%%%%%%%% %%%%%%% %%%%% %%%%% % %%%%%%% %%%%% %%%%%%% %%%%% %%% %%%%%%%%% %%%%%%%%%%%
% %         % %%%%%%%%%     %%%   %%% %     % %   %%%   %%%%%     %%%     % %%% % %%% %%%   %%%%%%%%%
% % %%%%% %%% %%%%%%%%%%%%% %%%%%%%%% %%%%% % % %%%%% %%%%%%% % % %%%%%%% % %%% % %%% %%%%%%%%%%%%%%%
%   %%%   %%% %%%%%%%%%%%%%   %%%%%         % % %   % %%%     % % %%%   % %       %%% %%%%%%%%%   %%%
% %%%%% %%%%% %%%%%%%%%%%%%%% %%%%%%% %%%%%%% %%% % %%%%%%%%% % %%%%%%% % %%%%%%% %%% %%%%%%%%% %%%%%
%   %   %%% %   %%% %%%%%%%%% %%%%%%%   % %%% %%% %     %%%%% %     %%% % %%%%%%% %     %%%   %     %
%%% % %%%%% %%% %%% %%%%%%%%% %%%%%%%%% % %%% %%% %%%%% %%%%% %%%%% %%% % %%%%%%% %%%%% %%% % %%% % %
%%% % %   %   %       %%%%%%% %%%   %%%     %       %%%   %%% %%%   %     %%%               % %%% % %
%%% % % % % % % %%%%% %%%%%%% %%% % %%%%%%% %%% %%%%%%% %%%%% %%% %%% %%%%%%%%% %%%%%%%%%%%%% %%% % %
%%% % % %   %   %%%   % %%%   %%% %   %%%   %%% %%%%%         %%%         %%%%%   %%%%%%%         % %
%%% % % %%% %%%%%%% %%% %%% %%%%% %%%%%%% %%%%%%%%%%%%%%% %%%%%%%%% %%% %%%%%%% %%%%%%%%% %%% %%% %%%
%   %   %%%   %%%         %               %%%%%%%%%%%%%%% %%%%%%%%% %%% %%%%%%% %%%%%%%%% %%% %%% %%%
%%%%%%%%%%%%%%%%%%%%%%%%%%%%%%%%%%%%%%%%%%%%%%%%%%%%%%%%%%%%%%%%%%%%%%%%%%%%%%%%%%%%%%%%%%%%%%%%%%%%%
