%%%%%%%%%%%%%%%%%%%%%%%%%%%%%%%%%%%%%%%%%%%%%%%%%%%%%%%%%%%%%%%%%%%%%%%%%%%%%%%%%%%%%%%%%%%%%%%%%%%%%
%     %%%         %%%%%%% %%%%%%%   %%%%%           %     %%%     %%%           %%% %%%       %%%%%%%
% % %%%%% %%%%%%% %%%%%%% %%%%%%% %%%%%%% %%%%%%% % % %%% %%%%% %%%%%%%%%%% %%% %%% %%% %%% %%%%%%%%%
% % %%%%% %%%%%%% %%%%%%%   %%%             %%%   % % %   %%%   %%%%%     % %%% %%% %%% %%% %%%%%%%%%
% %%%%%%%%%%%%%%% %%%%%%% %%%%%%%%%%% %%%%% %%% %%% %%% %%%%% %%%%%%% %%% %%%%% %%% %%%%%%% %%%%%%%%%
% %%%%%%%%%     % %%%%%%%     %%%%%%%   %%% %%% %%%     %%% %         % % %%%         %%%%%   %%%%% %
% %%%%%%%%%%% % % %%%%%%% % % %%%%%%%%% %%% %%% %%%%% %%%%% % %%%%% %%% % %%%%% % %%%%%%%%% %%%%%%% %
% %%%%%%% %%% %   % %%%   % % %%%%%%%%% %%% %%%   %%% %%%%%   %%%%% % %   %%%%% % %%%%%     %%%     %
% %%%%%%% %%% %%% % %%%%%%% %%%%%%%%%%% %%% %%%%% %%%%%%%%%%%%%%%%% % % %%%%%%% % %%%%%%% % %%%%% %%%
% %%%%%   %%% %%% %   %%%   %%%%%%%%%   %%% %%%   %%%%%   %%%%%%%%% %           % %%%%%%% %       %%%
% %%%%% %%%%% %%% % % %%% %%%%%%%%%%% %%%%% %%% % %%%%%%% %%%%%%%%% %%%%%%%%%%%%% %%%%%%%%% %%%%% %%%
% %%%%%   %%%   %   % %%%     %   %%%   %%%   % % %%%%%%%             %%%%% %%% %   %%%%%%% %%%%% %%%
% %%%%%%% %%%%% %%% %%%%% %%% % % %%%%%%%%%%%%% %%%%%%%%% %%% %%%%%%% %%%%% %%% %%% %%%%%%% %%%%% %%%
% %%% %%%   %%% %%% %%% %   %   %               %%% %%%%% %%% %%%%% % %     %       %%% %     %%%   %
% %%% %%% % %%% %%% %%% %%% %%%%%%%%% %%%%%%%%% %%% %%%%% %%% %%%%% % % %%%%% %%%%%%%%% % %%% %%%%% %
%       % % %%% %%% %%%     %%%%%%%%% %%%%% %%%   %   %%% %%%       % %   %%% %%%   %%%   %%%   %%% %
% %%%%% % % %%% %%% %%% %%%%%%%%%%%%% %%%%% %%%%% %%% %%%%%%%%%%%%% % %%% %%% %%% %%%%% %%%%%%% %%% %
%   %%%   %     %%%   %             % %%%   %%% % %%%   %%% %%%%%   %   %       % %%%   % %%%   %   %
%%% %%%%%%% %%% %%% %%%%%%%%%%% %%%%% %%% %%%%% % %%%%% %%% %%%%%%% %%% %%%%%%% % %%%%% % %%% %%%%% %
%%% %%%     %%% %%% %%%     %%% %%%%% %   %%%%% %   %%%         %%% %%%   %%%%%     %%%     % %%%%% %
%%% %%% %%%%%%% %%%%%%% % %%%%% %%%%% % %%%%%%% %%% %%%%%%%%%%% %%%%%%%%% %%%%% %%% %%%%%%%%% %%%%%%%
%   %%%   %   % %%%%%   %           % % %%% %     %   %%%%%%%%%   %%%%%%%   %%% %%% %%%%%   % %%%%%%%
% %%%%%%% % % %%%%%%%%% %%%%% %%%%%%% % %%% % %%% % %%%%%%%%%%%%% %%%%%%%%% %%%%%%%%%%%%% % % %%%%%%%
% %     % % %       %%%   %%% %       % %%% % %%%   %%%       %%%   %%%%%%%     %%%%%     %     %%%%%
% % %%% %%% %%% %%%%%%%%% %%% % % %%%%% %%% % %%%%%%%%% %%%%% %%%%% %%%%%%% %%% %%%%% %%% %%%%% %%%%%
%     %       %         % %%% % % %%%       %   %%%     %       %%% %%%   %   % %%%%% %%% %   % %   %
% %%%%% %%%%% %%%%% % %%% %%%%% %%%%%%%%%%% %%% %%%%%%%%% %%%%%%%%% %%% % %%%%% %%%%%%%%% % %%% % %%%
% %%%%% %S% %   %%% % %%% %%%   %%%%%%%%%     %   %%%%%%%     %%%       %   %%% %%% %%%   % %%%   %%%
% %%%%%%% % % %%%%%%% %%% %%% % %%%%%%%%% %%% %%% %%%%%%%%% % %%% %%% %%%%% %%% %%% %%% % % %%%%% %%%
% %   %%% %   %%%     %     % %   %%%       % %%% %   %%%%% %     %   %%%%%         %%% % % %%%%%   %
% %%% %%% %%%%%%% %%%%% %%%%% %%% %%% %%%%% %%%%% %%% %%%%% %%% %%%%% %%%%%%% %%%%%%%%%%% % %%%%%%% %
%     %%%   %%%   %%%%% % %%% %%% %%% %%%   %%%       %%%%%   %   %%% %%%     %%%     %%% %       % %
% %%%%%%%%% %%% %%%%%%% % %%% %%%%%%%%%%% %%%%% %%% %%%%%%%%% %%% %%%%%%% %%%%%%% %%% %%% %%%%% %%% %
% %%%     % %%% %%%%%   % %%%     %       %%%   %%% %%%   %%% %%%       % %         %     %%%%%     %
%%%%% %%% % %%% %%%%% %%% %%%%%%% % %%%%%%%%%%% %%%%%%%%% %%%%%%%%%%%%% %%% %%%%% %%% %%% %%%%%%% %%%
%     %%%   %%% %%% % %%%     %%% %         %%%   %%%           %%%%%%%   % %%%%% %%% %%%     %%% %%%
% %%%%%%%%%%%%% %%% % %%% %%% %%% %%%%%%% % %%%%% %%% %%%%% %%% %%%%%%%%% % %%%%% %%% %%%%%%%%%%%%%%%
%   %%%   %%%   %     %   %%% %%%   %   % %   %%% %%% %%%%% %%%     %%%%%   % %%% %     %%%%%%%%%%% %
%%% %%%%% %%% %%% %%%%%%%%%%% %%%%% % % %%%%% %%% %%% %%%%% %%%%% %%%%%%%%% % %%%%% %%% %%%%%%%%%%% %
%     %%%   %     %%%   %         % % % %%%   %   %   % %%% %%%   %%%%%%%%%   %     %   % %         %
%%%%% %%%%% % %%%%%%% % % %%% %%% % % % %%% %%% %%% %%% %%%%%%% %%%%%%%%%%%%% % %%%%% %%% % % %%%%% %
%%%%%   %%%   %%%     %   %   %%% %   % %   %%%     %%%   %%%   %%%%%%%%%%%%% %   %%% %     % %%%%% %
%%%%% %%%%% %%%%% %%%%% %%% %%%%%%% %%% % %%%%% %%%%%%% %%%%% %%%%%%%%%%%%%%% %%% %%% % %%% % %%%%% %
%%%%% %%%%%   %%% %   % %%%   %%%%% %   %       %%%%%   %     %%% %%%%%%%%%   %%% %%% % %%% %   %%% %
%%%%% %%%%%%% %%% % %%% %%%%% %%%%%%% %%%%%%%%%%%%%%% %%% %%%%%%% %%%%%%%%%%%%%%% %%% %%%%%%% %%%%% %
%%%%%     %       % %%%   %%% %%%%%   %%%%%%%%%%%     %%% % %%%   %%%%%   %%%%%   %%% %%%%%%% %%%   %
%%%%%%%%% %%% %%%%% %%% %%%%%%%%%%% %%%%%%%%%%%%% %%% %%% % %%%%% %%%%% % %%%%% %%%%% %%%%%%% %%%%% %
% %%% %%% %%% %%%%%     %%%   %     %%% %%% %%%   %%%   %   %     %%%   %       %       %%%     %%% %
% %%% %%% %%%%%%%%%%% %%%%% % %%% % %%% %%% %%% %%%%%%% %%% % %%% %%%%%%% %%%%%%%%% %%% %%% %%%%%%% %
%       %   %%%%%%%%% %%%   % %%% % %   %       %%%     %%% % %%%   %%%   %%%%%%%%% %%%     % %%%   %
% % %%% % %%%%%%%%%%% %%% %%% %%%%% % % %%%%% %%%%%%%%% %%% % %%%%% %%% %%%%%%%%%%%%%%%%%%%%% %%% %%%
% % %%% % %%%%%%%%%   %   %%%       % %     % %%%%%%%%% %%%     %%%     %%%%%     %%%%%%%     %   % %
% %%%%%%% %%%%%%%%% %%% %%%%% %%%%%%% %%%%% % %%%%%%%%% %%% %%%%%%%%%%% %%%%% % %%%%%%%%%%% % % %%% %
%   %     % %%%     %%% %%%%% %%%     %%%     %%% %%%%% %%% %%%%%   %%% %%%%% %   %%%   %%% %   %   %
%%% % %%%%% %%%%% %%%%% %%%%%%%%% %%%%%%%%%%% %%% %%%%%%%%%%%%%%% %%%%%%%%%%%%% % %%%%% %%% %%%%% %%%
%%% % %       %%%     % %       % %%%     %%% %%%   %%%%%%%%%%%%% %%% %%%%%%%%% %   %%%   % %%%   %%%
%%% % % %%%%% %%%%%%%%% % %%% % % %%% %%% %%% %%% %%%%%%%%%%%%%%% %%% %%%%%%%%% %%% %%%%% % %%% % %%%
%%% %   %       %%%%%%%   %%% % %     %%% %%%     %%%%% %%%%%%%%%     %%%%%%%     %   %%%       % %%%
%%% %%%%% %%%%% %%%%%%%%%%%%%%% %%%%%%%%% %%%%%%%%%%%%% %%%%%%%%%%%%% %%%%%%% %%%%% % %%%%% %%%%% %%%
%%%     %   %%% %%%%%%%     %%%   %%%%%       %%%%%       %%%   %%%%%   %%%   %%%%% %   %%% %%%   %%%
%%% %%% %%% %%%%%%%%%%% % %%%%%%% %%%%% %%%%% %%%%% %%%%% %%%%% %%%%%%% %%%%%%%%%%% %%% %%%%%%% %%%%%
% % %%%       %%%       % %%%     %     %%%%% %%%%% %%%%% %%%%%        !%   %%%     %   % %%%%% % %%%
% % %%%%%%%%% %%%%% %%%%% %%% %%%%% %%%%%%%%% %%%%%%%%%%% %%%%% %%%%%%% % % %%% %%%%% %%% %%%%% % %%%
%   %%%%%%%   % %%%   %       %%%   %%%%%         %%%%%%%   %%%   %   %   %     %%%       %%%     % %
% %%%%%%%%% %%% %%% % %%%%%%% %%%%% %%%%%%%%% %%% %%%%%%% %%%%%%% % %%%%%%%%%%%%%%% %%%%% %%%%%%% % %
%   %%%%%%%     %   % %%%%%%% %%%%% %%%%%%%%% %%%         %%%%%%% % %%%%%     %     %%%%% %%%%%   % %
%%%%%%%%%%%%%%% %%%%% %%%%%%%%%%%%% %%%%%%%%% %%%%%%% %%%%%%%%%%% % %%%%% %%% % %%%%%%%%% %%%%% %%% %
%%%%%%%%%%%%%   %%%   % %%% %%%       %%%%%%%     % % %%%%% %%%   %       %%% % %%%%%%%%% %%%%%     %
%%%%%%%%%%%%% %%%%% %%% %%% %%%%% %%% %%%%%%%%%%% % % %%%%% %%% %%% %%%%% %%%%% %%%%%%%%%%%%%%%%% %%%
%%%%%%%   %   %     %%%     %%%%% %%%   %%% %%%%% %     %%% %%% %       %       %%%%%%% %%%   %%% %%%
%%%%%%%%% % %%% % %%%%%%%%% %%%%% %%%%% %%% %%%%% %%%%%%%%% %%% %%%%%%%%% %%%%%%%%%%%%% %%% %%%%% %%%
%%%%%%%%%     % % %%% %%%   %     %%%%% %%%     % %%%%%%%%%   %   %%%%%%%   %           %%%         %
%%%%%%%%%%%%% %%% %%% %%% %%% %%%%%%%%%%%%% %%% % %%%%%%%%% % % % %%%%%%%%%%% %%%%%%%%% %%% %%% %%%%%
%%%%%%%%%%%%%     %       %%% %%%%%   %%%%% %%% %       %%% %   % %%% %%%%%%% %   %%%%%     %%%   %%%
%%%%%%%%%%%%%%%%%%% %%%%%%%%% %%%%%%% %%%%%%%%% %%%%%%% %%%%%%%%% %%% %%%%%%% % % %%%%%%%%%%%%%%% %%%
%%%%%%%%% %%%%%     %%%%%         %%% %%% %%%%%   %%%%%       %   %%% %         %     % %%%%%     %%%
%%%%%%%%% %%%%% %%%%%%%%% %%%%%%%%%%% %%% %%%%% %%%%%%%%% %%% % %%%%% % %%%%%%%%%%%%% % %%%%%%% %%%%%
%%%   %%%       %%%%%   %   % %%%%%       %%%%% %%%%%     %%%   %%%%%     %%%   %%%     %%% %%%   %%%
%%% % %%%%%%% % %%%%% % %%% % %%%%% %%%%% %%%%% %%%%% %%%%%%% %%%%%%%%%%% %%%%% %%% %%%%%%% %%%%% %%%
%%% %   %%%   %   %%% %   % %   %   %   %         %%% %%%   % %%% %%%%%%% %%%%%   %   %%%   %%%%% %%%
%%% %%%%%%% %%%%% %%% % %%% % % %%%%% % % %%%%%%%%%%% %%% %%% %%% %%%%%%%%%%%%% %%%%% %%% % %%%%%%%%%
%%% %%%%%     %%% %   % %%%   %   %   %   %%%%%%%%%   %           %%%%% %%%%%   %%% % %%% % %   %%%%%
%%% %%%%% %%% %%%%% % %%%%% %%%%% % %%% %%%%%%%%%%% %%% %%%%%%%%%%%%%%% %%%%% % %%% % %%% % % % %%%%%
%   %%%%% %     %%% %       %%%%%   %   %%%     %%% %%% %%% %%%%%%%       %   %     %     %   % %%%%%
% %%%%%%%%% %%%%%%% %%%%%%%%%%%%% %%%%% %%% %%% %%% %%% %%% %%%%%%%%%%% %%% % %%% %%%%% %%%%%%%%%%%%%
% %%%   %%%       % %     %%%%%%% %%%%%   %   %     %%%     %%%%%       %%% % %%% %%%%% %%%%%%%%%%%%%
% %%% %%%%% %%% % % %%%%% %%%%%%% %%%%%%% %%% %%%%%%%%%%%%%%%%%%% %%%%%%%%% % %%% %%%%% %%%%%%%%%%%%%
%     %%%   %%% % %   %%%   %%%   %   %%% %%% %%%%%%%             %%%%%%%%% % %%% %%%%% %%%%%%%   % %
%%% %%%%% %%%%% % %%% %%%%% %%%%% % % %%%%%%% %%%%%%% %%%%%%% % %%%%%%%%%%% % %%%%%%%%% %%%%%%% % % %
%%%     % %%%   % %%%         %%%   % %%%%%   %   %     %%%%% % %%%         % %%%%%%%           %   %
%%%%% %%% %%% %%% %%%%%%% %%%%%%% %%%%%%%%% % % % % %%%%%%%%% %%%%% %%%%%%%%% %%%%%%%%%%%%%%% %%%%% %
% %%%     %%% %%% %%%%%%% %%%%%   %%%%% %%% %   %   %%%%%     %         %%%%% %%%%%%%%%%%%% % %%%%% %
% %%% %%%%%%% %%%%%%%%%%% %%%%%%% %%%%% %%%%% %%%%%%%%%%%%% % % %%%%% %%%%%%% %%%%%%%%%%%%% % %%%%%%%
% %%% %     %   %%% %%%   %%%%%%%         %%% %%%       %%% %   %%%   %%%     %%%%%%%%%%% %   %   %%%
% %%% %%% %%% %%%%% %%% %%%%%%%%%%%%% %%% %%% %%% %%%%% %%%%%%%%%%% %%%%% %%%%%%%%%%%%%%% % %%% % %%%
%   % %%% %%% %         % %%%%%%%%%   %%% %%% %   %%%%%   %%%%%%%%%     % %     %   %%%%%       % %%%
% %%% %%% %%% % %%%%% %%% %%%%%%%%%%%%%%%%%%% % % %%%%%%% %%%%%%%%% %%%%% % %%% % % %%%%% %%%%% %%%%%
%     %   %%%     %%% %     %%%%%%%%%%%%%%%%%   %   %%%%%   %%%%%   %%%%%   %%%   %       %%%   %%%%%
% %%%%% % %%%%%%%%%%% % % %%%%%%%%%%%%%%%%%%%%%%% %%%%%%%%% %%%%% %%%%%%% %%%%% %%%%% %%%%%%%%%%%%%%%
%       %     %%%%%     % %%%%%%%%%%%%%%%         %%%         %%% %%%     %%%     %%% %%%%%%%%%%%%%%%
%%%%%%%%%%%%%%%%%%%%%%%%%%%%%%%%%%%%%%%%%%%%%%%%%%%%%%%%%%%%%%%%%%%%%%%%%%%%%%%%%%%%%%%%%%%%%%%%%%%%%
