%%%%%%%%%%%%%%%%%%%%%%%%%%%%%%%%%%%%%%%%%%%%%%%%%%%%%%%%%%%%%%%%%%%%%%%%%%%%%%%%%%%%%%%%%%%%%%%%%%%%%
%   %%% %%%%%%%%%%%%%%%%%%%%%%%%%%%%%%%%%%%%%%%%%%%%%%%%%%%           %%%   %%%   %%%%%%%       %%% %
%%% %%% %%%%%%%%%%%%%%%%%%%%%%%%%%%%%%%%%%%%%%%%%%%%%%%%%%%%% %%%%% %%%%%%% %%% % %%%%%%% %%%%% %%% %
%         %%%%%   %%% %%%%% %%%%%%%%%%%%%%%%%%%%%%%%%     %%%   %%% %%%         % % %%%   %%%       %
% %%%%%%% %%%%% %%%%% %%%%% %%%%%%%%%%%%%%%%%%%%%%%%% %%% %%% %%%%% %%%%% %%%%%%% % %%%%%%%%% %%% %%%
%     %%% %%%             %   %   %%%%%%%%%%%%%%%%%%% %%%     %     %%%%% %             %%%   %%% %%%
%%%%% %%% %%% %%%%%%%%%%% % % % % %%%%%%%%%%%%%%%%%%% %%%%%%%%% %%% %%%%% %%% %%%%%%%%% %%% %%%%% %%%
%%%   %%% %%%     %%%%%   % %   % %%%%%%%%%%%   %%%%%   %%%%%   %%%   %%% %%% %%%%%%% %     %%%   %%%
%%% %%%%% %%%%%%% %%%%% %%% %%%%% %%%%%%%%%%% %%%%%%%%%%%%%%% %%%%%%%%%%% %%% %%%%%%% %%%%%%%%% %%%%%
%%% %%%%% %%%%%%% %%%       %%%   %%%%%       %%%%% %%%%%     %     %%%   %   %%%%%%%   %%% %   % %%%
%%% %%%%%%%%%%%%% %%%%%%%%%%%%% %%%%%%%%% % %%%%%%% %%%%%%% %%% %%% %%% %%%%% %%%%%%% % %%% % %%% %%%
%%%     %%%   %%% %%%%%     %%%   %%% %%% % %%%       %%%%% %   %%%       %%%     %%% % %%% % %%% %%%
%%%%% %%%%% % %%% %%%%% %%%%%%%%% %%% %%%%% %%%%% %%%%%%%%% % %%%%% %%%%% %%% %%% %%%%% %%% % %%% %%%
%     %%%   %   %       %%%%% %%%         %   %%%     %%%%%   %%%   %%%%% %%% %%% %   %         %   %
% % %%%%%%%%% %%% %%%%% %%%%% %%%%%%% %%% % %%%%%%% % %%%%%%%%%%% %%%%%%% %%% %%%%% % %%%%%%%%% % %%%
% % %   %%%%% %%% %%%     %   %%% %%%   %   %%%%%%% %     %%%%%   %%%       % %     %   %%%%%%% %   %
% %%% % %%%%% %%% %%%%%%% %%% %%% %%%%% %%%%%%%%%%% % %%%%%%%%%%%%%%%%%%%%% %%% %%%%%%% %%%%%%% %%% %
%     %       %%% %%%%%%%         %%%   %%%%% %%%   % %%%%%%%%%%%%%%%%%%%%% %%% %%%%%%% %%%         %
% %%%%% %%%%%%%%% %%%%%%% %%%%% %%%%% %%%%%%% %%%%%%% %%%%%%%%%%%%%%%%%%%%% %%% %%%%%%% %%%%%%%%%%% %
% %%%   %%%%%%%   % %%%   %%%   %%%   %%%     %%%%%%%     %%%%%   %%%%%%%         %%%         %%%   %
% %%% %%%%%%%%% %%% %%%%%%%%%%% %%% % %%%%% %%%%%%%%% %%% %%%%% % %%%%%%% %%%%% %%%%% %%%%%%% %%% %%%
%   %   %%%   %     %%%%%%%%%%%   % %     %           %%% % %%% % %%%%%   %%%%% %%%%%   %%%   %%% % %
%%%%%%% %%% %%%%%%% %%%%%%%%%%% %%% %%%%% %%% %%%%% %%%%% % %%% %%%%%%%%%%%%%%%%%%%%%%%%%%% %%%%% % %
%%%%%%%     %%% %%%   %%% %%%   %%% %   %     %%%   %%%         %%%%%%%     %%%       %%%       %   %
%%%%%%% %%%%%%% %%% %%%%% %%% %%%%% % % %%%%% %%% %%%%%%%%%%%%%%%%%%%%% %%% %%% %%%%% %%%%% %%% %%%%%
%       %%%%%%% %   %%%         % %   %   %%% %%%     %%%%%%%%%%%       %%%   %   %%%   %%% %%%   %%%
% %%%%% %%%%%%% % %%%%% %%% %%% % %%%%%%% %%% %%%%%%% %%%%%%%%%%% % %%% %%%%% % % %%%%% %%%%%%%%% %%%
%   %%% %         %%%%% %%% %%%   %       %%%   %%%%% % %%% %%%   %   % %%%   % %   %%%   %%%%%%% %%%
% %%%%% % %%% %%% %%%%%%%%%%%%%%%%% %%%%% %%%%%%%%%%% % %%% %%%%% %%% %%%%%%% % %%% %%%%% %%%%%%% %%%
% %%%     %%% %%%   %   % %%%       %%%     %%%%%           % %%% %%%     %%% % %%%   %%%   %%%%%   %
%%%%% %%%%%%%%%%%%% % % % %%% %%% %%%%%%%%%%%%%%%%%%% %%%%% % %%%%%%%%%%% %%% %%%%% %%%%%%% %%%%% %%%
%%% %       %%%%%%% % %   %   %%% %%%%%%%%%%%%%%%%%%% %%% %   %%%         %%%     % %%%%%   %     %%%
%%% %%%%%%% %%%%%%%%% %%% %%% %%% %%%%%%%%%%%%%%%%%%%%%%% %%% %%% % %%%%%%%%%%%%% % %%%%% %%% %%% %%%
%     %%%%%   %%% %%% %%%     %%% %%%%%%%%%%%%%%%%%%%%%       %%% % %%%%%%%     %   % %%%     %%%   %
% %%%%%%%%%%% %%% %%% %%%%% %%%%%%%%%%%%%%%%%%%%%%%%%%%%% %%%%%%% %%%%%%%%%%% % %%% % %%% %%% %%% %%%
%   %%% %%%%%     %%% %%%   %%% %%%%%%%%%%%%%%%%%%%%%%%%% %%%%%     %%%       %   %   %%% %%% %%% %%%
%%% %%% %%%%%%% %%%%% %%%%%%%%% %%%%%%%%%%%%%%%%%%%%%%%%% %%%%%%% % %%%%%%% %%%%%%%%% %%%%%%%%%%% %%%
%%%       %%%%% %%%%%     %     %%%%%%%%%%%%%%%%%%%%%%%       %%% % %%%%%%%     %     %%%%% %%%   %%%
%%%%% % %%%%%%% %%%%%%%%% % % %%%%%%%%%%%%%%%%%%%%%%%%%%%%%%% %%%%% %%%%%%% %%% % %%%%%%%%% %%%%% %%%
% %%% % %%%%%%%   %%%%%%%   % %%%%%%%%%%%%%%%%%%%     %%%%%%%       %       %%%   %%%%%       %%%   %
% %%%%% %%%%%%% %%%%%%%%% %%% %%%%%%%%%%%%%%%%%%%%%%% %%%%%%%%%%% %%% %%%%% %%%%%%%%%%% % % %%%%% %%%
%   %%%   %    !%%%%%%%   %%%     %%%%%%%%%%%%% %%%%%     %%%%%   %%% %%%%% % %%%%%     % % %%%   %%%
% % %%%%% % %%%%%%%%%%%%% %%%%%%% %%%%%%%%%%%%% %%%%% %%% %%%%% %%%%%%%%%%% % %%%%% %%%%% % %%%%%%%%%
% %   %%%   % %%%%%%% %%% %%%%%%%     %%%%%%%%%   %%% %   %     %%%%%%%       %%%%% %%%   %   %%%%%%%
% %%%%%%% %%% %%%%%%% %%% %%%%%%% %%%%%%%%%%%%% % %%% %%%%% %%%%%%%%%%%%% %%%%%%%%%%%%% %%%%% %%%%%%%
% %%%%%   %     %%%%%   % %   %   %%%%%%%%%%%   % %%%   %%%   %%%%%%% %%%   %%%   %%%       % %%%%% %
% %%%%% %%% % %%%%%%% %%% % %%% %%%%%%%%%%%%% %%%%%%%%% %%%%% %%%%%%% %%%%%%%%% %%%%%%% %%% %%%%%%% %
% %%%%%     % %%%     %     %%% %%%             %%%%%%% %%%%%   %%%     %%%%%       %%% %%% %%%     %
% %%%%%%%%% %%%%% % %%% %%%%%%% %%%%%%% %%%%%%% %%%%%%% %%%%%%% %%%%% %%%%%%%%% % %%%%% %%% %%%%%%% %
% %%%%%     %%%%% % %   %%%%%   %%%%%%% %%%     %%%%%   %%%%%%%     %   %%%%%%% % %%%     %     %%% %
% %%%%% %%% %%%%%%% % %%%%%%% %%%%%%%%%%%%% % %%%%%%% % %%%%%%%%%%% %%% %%%%%%%%% %%% %%%%% %%% %%% %
% %%%%% %%% %%% %%%   %%%%%   %%%%%%% %%%%% % %%%     %   %%%   %%% %%%             %   %%% %%%     %
% %%%%% %%%%%%% %%%%%%%%%%%%% %%%%%%% %%%%% %%%%%%%%%%% % %%% % %%% %%% %%% %%%%%%% %%%%%%% %%%%%%% %
%   %%%   %%%%%   %%%%%%%       %%% %       %%%   %%%%% %     % %   %   %   %%% %%%           %%%   %
% %%%%%%%%%%%%%%% %%%%%%% % %%%%%%% % %%% %%%%% % %%%%% %%%%% %%% %%%%%%% %%%%% %%%%%%%%%%%%% %%%%% %
% %%% %%%         %   %%% % %%%     % % %       %   %%%     % %   %%%%%%%     %   %%%     %%%   %%% %
% %%% %%% %%%%%%% % %%%%%%% %%% %%% % % %%%%%%% %%% %%%%% %%% % %%%%%%%%% %%% %%% %%%%%%% %%% %%%%%%%
%     %%% %     % %       %   % %   % %   % %%% %%% % %%% %%% % %       %   % %%%   %%%   %%% %%%%%%%
%%% % %%% %%% %%% %%%%% % %%% % % %%% % % % %%%%%%% % %%% %%% % %%% %%%%%%% % %%% %%%%% %%%%% %%%%%%%
%%% % %   %%% %%% %%%   % %%%   %       %   %%%     % %%% % %   %%%   %%%%% %   %         %%%   %%%%%
%%% % % %%%%% %%% %%% %%% %%%%%%% %%%%%%% %%%%% %%%%% %%% % %%%%%%% % %%%%% %%% % %%% %%% %%% %%%%%%%
%S  %   %%%%%   % %%% %%%   %%%%%   %%%%% %%%   %%%%%   % %     %%% %   %   %   % %%% %%%     %%%%%%%
% %%%%% %%%%%%% % %%% %%%%% %%%%%%%%%%%%% %%% %%%%%%%%% % %%%%% %%%%% % % %%% %%% %%%%%%%%%%% %%%%%%%
% %%%%%   %%%%%   %   %   %   %%%%%%% %%%   %   %   %%% % %%%%%   %%% % %   %   % %%%%%%%%%%%   % %%%
%%%%%%%%%%%%%%% %%% %%% % %%% %%%%%%% %%%%%%%%% %%% %%% % %%%%% %%%%% % %%% %%% %%%%%%%%%%%%%%% % %%%
%%%%% %%%%%%%     % %%% %   %       %   %%%%%   %%%     % %%%%% %   % %     %%%   %%%   %%%   % %   %
%%%%% %%%%%%%%%%% % %%%%% %%% %%%%% % % %%%%% % %%% %%%%% %%%%% % % % %%%%%%%%%%% %%% %%%%% % % %%% %
%%%   %     %%% %   % %%% %%% %%%     %   %   % %%%   %     %     %   %%%       % %%%   %%% %   %   %
%%%%% % % %%%%% %%%%% %%% %%%%%%% %%%%%%% %%% %%%%% % % %%% %%%%%%% %%%%% %%%%%%% %%%%% %%% %%%%% %%%
%%%%%   % %     %%%       %%%%%%% %%%%%     % %%%   %   %%%     %%%       %%%%%%% %%%%% %%% %%%   %%%
%%%%% %%% % %%% %%% %%% %%%%%%%%%%%%%%%%%%% % %%%%% %%%%%%%%%%% %%% %%%%%%%%%%%%% %%%%% %%% %%%%% %%%
%%%   %%%   %%% %%%   % %%%     %%%   %%%     % %%% %%%%%%%     %%% %%%%%%%%%     %%%   %%% %%%%%   %
%%% %%%%% %%%%% %%%%% %%%%% %%% %%% %%%%% %%% % %%%%%%%%%%% %%%%%%%%%%%%%%%%% % %%%%% %%%%% %%%%%%% %
%     %%%     % %%%   %%%     %     %%%   %%%     %%%%%%%%% %%%   %%%%%%%%%%% %       %%%       %%% %
%%%%% %%%%%%% % %%% %%%%%%%%%%% %%% %%%%%%%%% %%% %%%%%%%%% %%% % %%%%%%%%%%% %%%%%%% %%%%% %%% %%% %
%%% % %%%%%   %     %%%     %%% %   %%%%%%%%% %%% %%%%%%%%% %   % %%% %%%%%%%     %%%   %%% %%%     %
%%% % %%%%%%%%%%% %%%%% %%% %%%%% %%%%%%%%%%% %%%%%%%%%%%%% % %%% %%% %%%%%%% %%% %%%%% %%%%%%% %%% %
%       % %%%%% %       %%%       %%%         % %%%%% %%% % % %%%     %%%%%%% %%%   %%%   %%%   %%% %
% %%%%% % %%%%% %%%%% %%%%%%% %%%%%%% %%% %%%%% %%%%% %%% % % %%%%% %%%%%%%%% %%%%%%%%%%% %%%%% %%% %
% %%%       %   %     %%%   % %%%     %%% %%%   %%%       % % % %%% %%%%%%%   %%%%%     %   %%% %%% %
% %%%%%%%%% % %%% %%%%%%% %%% %%% %%%%%%%%%%%%% %%%%% %%% % % % %%% %%%%%%% %%%%%%% %%% %%% %%% %%% %
%   %%%%%     %%%     %   %%%   % % %%% %%%     %%%%% %%%     % %%%   % %%% %%%     %%% %%% %   %%% %
%%%%%%%%%%%%%%%%% %%% %%% %%% %%% % %%% %%% %%%%%%%%%%%%%%%%%%% %%%%% % %%%%%%%%%%% %%% %%% % %%%%%%%
%%%%%   %%%%%%%%% %   %%%     %   % %   %%% %%%%%%%%%%% %%% %%% %     %         %   %       %   % %%%
%%%%%%% %%%%%%%%%%% %%%%%%%%%%% %%% % % %%% %%%%%%%%%%% %%% %%% % %%%%% %%%%%%% % %%%%%%% %%%%% % %%%
% %%%%%   %%%       %%%     %%% %%%   %       %%%%%%%             % %%%   %%%%%   %%%%%   %%%%%   %%%
% %%%%% %%%%%%% %%% %%% %%% %%% %%%%%%% %%% %%%%%%%%% %%%%% %%%%%%% %%%%% %%%%%%%%%%%%% %%%%%%% %%%%%
% %%%     %%%   % % %%%   %     %%%%%%% %%% %%%   %%%   %%%         %%%%%     %%%%%%% %   %%%   %%% %
% %%%%%%% %%% %%% % %%% %%% %%%%%%%%%%% %%% %%% % %%%%% %%%%% %%%%% %%%%%%% % %%%%%%% %%% %%%%%%%%% %
%   %%%%%     %%%     % %%% %%%         %       %   %%% %%%   %%%         % % %%%%%   %%%   %%%%%   %
%%% %%%%% % %%%%%%%%%%% %%%%%%% %%%%%%%%% %%%%%%% %%%%% %%%%%%%%%%%%%%%%% % %%%%%%%%% %%%%% %%%%% %%%
%%%       % %   %%%       %%%%%     %   % %%%     %%%   %%%%%%%%%%%   %%%   %%%         %%%       %%%
%%% %%% %%%%% % %%% %%%%% %%%%%%%%%%% % % %%%%% %%%%%%% %%%%%%%%%%%%% %%%%%%%%%%%%% % %%%%% %%%%%%%%%
%%% % %       %     %%% % %     %%%   %     %%% % %%%%% %%%   %%% %%%       %%%     % %     %%%%%%%%%
%%% % %%%%%%%%%%%%% %%% % % %%% %%% %%%%% %%%%% % %%%%% %%%%% %%% %%%%%%%%% %%% %%%%%%% %%%%%%%%%%%%%
%%%       %%%%% %%% %%%     %%% %%% %     %%%%%   %%%%%   %%% %             %         % %%%%%%%%%%%%%
%%%%%%% %%%%%%% %%%%%%% %%% %%% %%% % %%%%%%%%%%% %%%%%%%%%%% % %%% % %%% %%% %%%%% % % %%%%%%%%%%%%%
%%% %   %%%     % %%%%% %%% %%% %%% % % %%% %%%%% %%% %%%%%     %%% % %%% %   %%%%% %   %%%%%%%%%%%%%
%%% % %%%%% %%% % %%%%% %%% %%% %%% % % %%% %%%%%%%%% %%%%% %%% %%%%% %%%%% %%%%%%%%% %%%%%%%%%%%%%%%
%%%         %%%     %%% %%% %%%     %           %%%         %%% %%%%%       %%%%%%%%% %%%%%%%%%%%%%%%
%%%%%%%%%%%%%%%%%%%%%%%%%%%%%%%%%%%%%%%%%%%%%%%%%%%%%%%%%%%%%%%%%%%%%%%%%%%%%%%%%%%%%%%%%%%%%%%%%%%%%
