%%%%%%%%%%%%%%%%%%%%%%%%%%%%%%%%%%%%%%%%%%%%%%%%%%%%%%%%%%%%%%%%%%%%%%%%%%%%%%%%%%%%%%%%%%%%%%%%%%%%%
%       %     %%%             %%%%%%%       %%%%%%% %     %%%     %%% %%%       % %%%%%         %%%%%
%%%%% % % %%% %%% %%%%%%% %%% %%%%%%% %%%%% %%%%%%% % %%% %%%%% % %%% %%%%% % % % %%%%%%% % %%% %%%%%
%%%%% %   %   %   %   %%% %%%     %%% %   %     %%% %   %   %%% %       %%% % %   %   %%% % %       %
%%%%%%% %%% %%% %%% %%%%%%%%%%%%% %%% % %%%%% % %%% %%% %%% %%% %%% % %%%%%%% %%% %%% %%%%% %%%%%%% %
%%%%%%% %%% %%% %%%     %%%       %     %%%%% %         %   %%% %%% % %%%%%%% %   %     %%% %%%     %
%%%%%%%%%%% %%% %%%%%%% %%% % %%%%% %%%%%%%%% %%%%% %%%%% %%%%%%%%% %%%%%%%%% % %%% %%%%%%% %%%%%%% %
%%%%% %%% %     % %%%%% %%% %       %%%%%%% % %%%%% %%%   %%%%%     %%%%%%%   %   % %%%%%     %%%%% %
%%%%% %%% % %%%%% %%%%% %%%%% %%% %%%%%%%%% % %%%%%%%%% %%%%%%% %%%%%%%%%%% %%%%% % %%%%% %%% %%%%% %
% %   %%%   %%%%%       %%%%% %%% %%%%%           %%%%%     %%%   %%%       %%% %   % %%% %%%   %%% %
% % % %%% %%%%%%%%%%% % %%%%% %%%%%%%%% %%%%%%% %%%%%%%%% % %%%%% %%% %%% % %%% %%% % %%% %%%%% %%%%%
%   % %%%     %%%     % % %%%   %%%%%     %%%%% %       % % %%%   %   %%% % %%% %   % %%%   %%% %%%%%
% %%% %%%%%%% %%% %%%%% % %%%%%%%%%%%%%%%%%%%%% % % %%% %%% %%% % %%%%%%% % %%% % %%% %%%%% %%% %%%%%
%   %     %%% %   %%%       %%%%%   %%%   %%%   % % %%% %   %   % %%%%%%% % %               %%%   %%%
% %%%%% %%%%% % %%%%%%%%%%% %%%%%%% %%% % %%%%%%% % %%% % %%% %%% %%%%%%%%% %%% %%% %%%%%%%%%%%%% %%%
% %%%%% %     % %%% %%% %%% %%% %%% %   %       % % %%%   %   %             %%% %%% %%%       %%%   %
%%%%%%% % %%%%% %%% %%% %%% %%% %%% % %%%%%%%%% % %%%%%%%%%%% %%% %%%%%%%%% %%%%%%% %%% %%%%% %%% %%%
%%%%%%%     %%% %   %%%     %       % %   %%%%%   %%% %%% %%% %%% %%% %%%   % %%%   %%% % %%%   % %%%
%%%%%%%%%%% %%% % %%%%% %%%%% % % %%% %%% %%%%%%%%%%% %%% %%% %%%%%%% %%% %%% %%%%%%%%% % %%%%% % %%%
% %%% %%%%% %   % %%%%% %%%   % % %%% %%%           %     %     %%% %         % %%%%%%%   %%%   % %%%
% %%% %%%%% % %%% %%%%% %%%%%%% % %%% %%%%%%% % %%%%% % %%% %%% %%% % %%%%%%% % %%%%%%% %%%%% %%%%%%%
%     %%%%%   %%%   %%%     %   % % %   %%%%% % %     %   % %%% %%%     %%%%%     %%%   %%%%%       %
% %%%%%%%%%%%%%%% %%%%% %%% % %%% % % %%%%%%%%% % %%%%%%% % %%% %%%%%%%%%%%%%%%%% %%% %%%%%%%%%%%%% %
% %       %%%%%   %%%   %%%   %%%   % %%%%%%%%%   %%%%%%%     %   %       %   %   %%%     % %     % %
% % %%% %%%%%%% %%%%%%%%%%%%% %%%%%%% %%%%%%%%%%%%%%%%%%%%% %%% % % %%%%% % % %%%%%%% %%% % % %%% % %
%   %   %%%     %%%%%%%%% %%%   %   %   %%%%%%%%%%% %%%%%%% %%% %   %   %   %   %%%   %%%   % %%% % %
% %%% %%%%% %%%%%%%%%%%%% %%% %%% % % % %%%%%%%%%%% %%%%%%%%%%% %%%%% %%%%%%%%% %%%%% %%%%% % %%% % %
% %%%             %%%     %%% %%% %   % %%%%%%% %         %%%%% %%%%%   %%%   %   %%%   %%% % %     %
% %%%%%%%%%%% %%% %%% %%%%%%% %%% % %%%%%%%%%%% % % %%%%%%%%%%% %%%%%%% %%% % %%% %%% %%%%%%% %%%%%%%
%     %%%%%%% %%%     %%%     %%% % %%%%%%%%%     %       %%%       %%%     %   %     %%%     %%%%%%%
%%%%%%%%%%%%% %%%%% %%%%% %%%%%%% % %%%%%%%%%%% %%%%%%%%% %%%%%%% %%%%% %%%%% % %%%%%%%%%%% % %%%%%%%
%%%%%%%         %%%   %%%   %%%   %   %%%%%%%%% %%%     % %%%%%   %%%       % %   %       % % %%%   %
%%%%%%%%% %%%%%%%%%%% %%%%% %%%%% %%% %%%%%%%%% %%% %%%%% %%%%% %%%%% %%%%%%% % %%% %%%%% % % %%% % %
%     %%% %%%%%%%%%%%       %%%%% %   %%%%%%%%%     %%%   %%%%% %%%%% %%%%%   % %%%   %%%   %     % %
% %%% %%%%%%%%%%%%%%%%% %%%%%%%%% %%%%%%%%%%%%%%%%% %%% % %%%%% %%%%%%%%%%% %%% %%%%% %%%%%%%%% %%% %
%   %   %%%%%       %%% %%%     %   %%% %%%%% %%%   %%% % %     % %%%       %%% %%%%% % %%% %   %%% %
% %%% % %%%%%%%%% %%%%% %%%%% %%%%% %%% %%%%% %%%%% %%% %%% %%%%% %%% %%%%%%%%% %%%%% % %%% % %%%%%%%
% %%% %   %%%%%%% %%% % %     %%% %   %   %%%   %%%   % %%% %%%%%   % %%%       % %   %       %%%%%%%
% %%% %%%%%%%%%%% %%% % % % %%%%% % % % % %%% %%%%% %%% %%% %%%%% % % %%% %%%%%%% % % %%% %%%%%%%%%%%
%   %   %%%%% %     %   % % %%%   % %   % %%% %%%   %%% %%%   %%% %   %%% %%%     % % %%% %%%   %%%%%
%%%%% % %%%%% % % %%% %%% %%%%%%% % %%% %%%%% %%%%%%%%% %%%%% %%% %%%%%%% %%%%%%% % %%%%% %%% % %%%%%
%%%%% %         %     %   %%%     % %%% %%%   %%%%%       %%% %%% %%%     % %%%%% % %%%       % %%%%%
%%%%% %%%%%%%%%%%%% %%%%% %%% %%%%% %%% %%%%% %%%%% % %%%%%%% %%% %%% %%% % %%%%% % %%%%%%%%%%% %%%%%
%       %%% %%% %%% %%%%%     %%%%% %     %%%    S% % %%%%%%% %%% %   %%%         % % %%%%% %%%   %%%
%%%%%%% %%% %%% %%%%%%%%% % %%%%%%% %%%%%%%%% %%%%% %%%%%%%%% %%% % %%%%%%%%% %%%%% % %%%%% %%%%% %%%
%%%%%%%   % %%%   %%% %%% % %%%%% %           %%%%%     %%%%%   % % %%%%%%%%% %%%%% %         %     %
%%%%%%%%% % %%% %%%%% %%% %%%%%%% %%%%%%%%%%%%%%%%%%% % %%%%%%% % % %%%%%%%%%%%%%%% % %%%%%%%%% %%%%%
%%%%%%% %       %%%%% %       %%% %%%     %%%%%       % %%%       %   %%%           %         % % %%%
%%%%%%% %%% %%% %%%%% % %%%%% %%% %%%%% %%%%%%% %%% %%%%%%% %%%%%%% %%%%% %%% %%%%%%%%%%% %%% % % %%%
%%%%%   %%% %%%   %%% % %%%%%       %%% %%%   % %   %%%%% %     %%% %%%   %%% %     %%%%% %%%   %   %
%%%%% %%%%% %%%%% %%% % %%%%% % %%%%%%% %%% % % %%%%%%%%% % %%%%%%%%%%% %%%%% %%%%% %%%%% %%%%%%% %%%
%     %%%%% % %%% %%%   %%%   % %%%%%   %%% %   %           %%%%% %%%%% %%%   %%%%% %     %%%%%   %%%
% % %%%%%%% % %%%%%%%%%%%%%%% %%%%%%% % %%% %%% % %%%%%%%%%%%%%%% %%%%%%%%% % %%%%% % %%% %%%%%%% %%%
% %         %   %%%%%%%%% %%% %%%%%%% % %%% %   % % %%%%%%%           %%%%% % %%% %   %%% %%%%%     %
% %%%%%%%%%%% % %%%%%%%%% %%% %%%%%%%%% %%% % %%% % %%%%%%% %%% %%%%% %%%%%%% %%% % %%%%% %%%%% %%%%%
%       %%%%% % %%%             %%%%%%%     % %%%   %%%%%%% %%% %%%   %%%%%%% %%%   %%%   %       %%%
%%%%%%% %%%%%%% %%% %%%%%%%%% %%%%%%%%% %%% % %%%%% %%%%%%% %%%%%%% % %%%%%%% %%% %%%%%%% %%%%%%% %%%
%   %   %%%     %%% %   %%%   %%%%%%%   %%% % %%%   %   %%% %       % %%%%%   %       %%%   %%%%% %%%
% % % %%%%% % %%%%% % %%%%% %%%%%%%%%%% %%% %%%%% %%% % %%%%% %%%%% %%%%%%% %%% %%%%%%%%%%% %%%%% %%%
% %   %%%   % %%%     %%%%% %%% %%% %%%   % %%% %     % %     %     %%% %%%   % %   %%% %%% %%%%%   %
%%% %%%%% %%%%%%%%%%% %%%%% %%% %%% %%%%%%% %%% % %%%%% % %%%%%%%%%%%%% %%% % %%% % %%% %%% %%%%%%% %
%%% %           %%%   %%%%%             %%%     % %%%     %%%             % % %   % %%%     %%% %%% %
%%% %%%%%%%%% % %%%%%%%%%%%%% %%%%%%%%% %%% % %%% %%%%%%%%%%% %%%%%%%%%%% %%% % %%% %%%%% %%%%% %%% %
%       %%%%% %   %%%%%%% %%%   %%%%%%%   % %     %%%%%%%%%   %%%     %%% %%%   %   %%%%%           %
% %%%%% %%%%%%%%% %%%%%%% %%% % %%%%%%%%% % %%%%%%%%%%%%%%% %%%%%%%%% %%% %%% %%% % %%%%%%%%%%%%%%% %
% %%%       %%%%%   %         % %%%%% %%% %   %%%       %   %   %%%     % %%% %%% %     %%%   %%% % %
%%%%%%%%%%% %%%%%%% % %%%%%%%%% %%%%% %%% %%%%%%% %%%%% %%% %%% %%% %%%%% %%%%%%% %%%%% %%% % %%% % %
%%%%%%%   %       %       %%%%%     %     %%%%%%%   %%% %%% %%%           % %%%   %     %%% %       %
%%%%%%%%% %%%%%%% %%%%% %%%%%%% %%% %%% %%%%%%%%%%% %%% %%% %%%%% %%%%%%%%% %%%%% %%% %%%%% %%%%% %%%
% %%% %%%         %%%%% %%%%%%% %%%   % %%%%%%%     %   %%%     % %   % %%% %%%%%   %   %%%   %%% %%%
% %%% %%% %%%%%%%%%%%%% %%%%%%% %%%%% % %%%%%%%%% %%% %%%%% %%% % % % % %%% %%%%%%% %%%%%%%%%%%%% %%%
% %%%   % %%%   %%% %%% %%%%%%% % %   % % %%%     % %   %%% %%% %   %         % %%%         %%%   % %
% %%% % % %%% %%%%% %%%%%%%%%%% % % %%% % %%% %%%%% % %%%%%%%%% %%% %%%%%%%%% % %%%%% %%%%% %%%%% % %
% %   %   %%% %%%!  %%%%% %       % %   %     %%%%%   %%%       %%% %%% %%%%%   % %%%     %   %%%   %
% % %%% %%%%% %%% %%%%%%% % %%%%%%% %%% % %%%%%%%%% %%%%% %%%%%%%%%%%%% %%%%%%% % %%% %%%%% %%%%%%% %
% % %%% %%%       %%%%%     %%%%%%% %%%   %%% %     %     %     %%%%%       %%%     % %%%   %%%     %
% % %%%%%%% % % %%%%%%%%%%%%%%%%%%% %%%%%%%%% % %%%%% % % %%% %%%%%%%%%%% %%%%%%%%% % %%% %%%%% %%%%%
% %   %%%   % % %%%   %%%%%%% %%%       %%%     %%%%% % % %%%     %%%%%%%       %%% % %%% %%% % %   %
% %%% %%% %%% %%%%% % %%%%%%% %%%%%%%%% %%% %%%%%%%%% % % %%% %%% %%%%%%% % %%%%%%% %%%%% %%% % %%% %
%     %%% %%%       %   %     %%%%%%%%% % % %   %%%   % % %%%   %     %   % %%%%%     %   %   % %%% %
% %%%%%%%%%%% %%% %%%%% % %%% %%%%%%%%% % % %%% %%%%%%% %%%%% %%% %%%%% %%% %%%%%%%%% %%% %%% % %%% %
% %   %%%%%     % %       %%% %%% %%%%% %   %%%   %%%%% %%%   %%% %%%   %%%     %%%   %%% %%%     % %
% % % %%%%% %%%%% %%% %%%%%%%%%%% %%%%% % %%%%% % %%%%% %%% %%%%% %%% %%%%%%% %%%%% %%%%% %%%%%%% % %
% % %   %%% %%%   %%%   %%%%%%%     %%% %       %   %   %       %     %%%%%%%       %       %%%%%   %
% % %%% %%%%%%% %%%%%%%%%%%%%%%%% %%%%% %%% %%% %%% % %%% %%%%% %%%%% %%%%%%%%%%%%%%% % %%%%%%%%%%% %
% % %   %%%%%   %%% %%%%%%%%%%%%%       %%% %%% %%%   %%% %%%     %%% %%%       %%%   % %%%%%%% %%% %
% % %%% %%%%%%% %%% %%%%%%%%%%%%%%% %%% %%% %%%%%%%%%%%%%%%%%%% %%%%% %%%%% %%% %%%%% %%%%%%%%% %%% %
%   %%%     %%% %%% %%%%% %%%%% %%% %%% %%%   %%% %%%   %%%%%%% %%%     %%% %%% %%%%%       %%%     %
%%%%%%%%%%% %%% %%% %%%%% %%%%% %%%%%%% %%% %%%%% %%%%% %%%%%%% %%%%%%% %%% %%% %%%%%%%%% %%%%% %%% %
%%%%%   %%% %   %%% %             %     %   %%%         %%%%% %   %%%   %     %     %%%%%     % %%% %
%%%%%%% %%% %%% %%% % %%%%%%% %%% % % %%% %%%%%%% %%%%%%%%%%% % %%%%% %%%%%%%%%%% % %%%%%%%%% % %%% %
%%% %%%   %       %     %%%   %%%   % %%%     %%% %       %     %%%     %%%%%%%%% % %%%%%%%%% % %%% %
%%% %%% %%%%%%%%% % %%% %%% % %%%%%%% %%%%%%%%%%% % %%%%% % %%%%%%%%%%% %%%%%%%%%%% %%%%%%%%% %%%%% %
%%% %%% %%%       % %%% %%% % %%%       %%%%%%%%% % %%% %   %%%%% %%%     %     %%%   %%%%%%% %%%   %
%%% %%% %%% %%%%%%%%%%% %%% % %%% %%%%% %%%%%%%%% % %%% %%% %%%%% %%% %%% %%% % %%%%% %%%%%%% %%%%% %
%%%     %%% %%%%%   %     % % %%%   %%%     %%%%%       %%%   %%% %%% %%% %%% % % %%% %%%%%%%   %%% %
%%%%% %%%%% %%%%% % %%%%%%% %%%%% %%%%%%%%% %%%%%%%%%%% %%%%% %%% %%%%%%% %%% % % %%% %%%%%%% %%%%% %
% %%%       %     % %       %%%%% %%% %%%     %%%%%   % % %%% %     %%%%% %%% % %     %%% %%%   %%% %
% %%% %%%%% % %%%%% % %%% %%%%%%% %%% %%%%%%% %%%%% % % % %%% %%% %%%%%%% %%% % % %%% %%% %%%%% %%% %
%       %%%   %%%%%   %   %%%         %%%%%     %%% %     %%%     %%%%%%%     %   %%%           %%% %
%%%%%%%%%%%%%%%%%%%%%%%%%%%%%%%%%%%%%%%%%%%%%%%%%%%%%%%%%%%%%%%%%%%%%%%%%%%%%%%%%%%%%%%%%%%%%%%%%%%%%
