%%%%%%%%%%%%%%%%%%%%%%%%%%%%%%%%%%%%%%%%%%%%%%%%%%%%%%%%%%%%%%%%%%%%%%%%%%%%%%%%%%%%%%%%%%%%%%%%%%%%%
%%% %%%     %%%   %%%     % %%%%% %%%%%   %%% %%%!  %%%   %%%%%%%%%     %%% %%%%%   %%% %%%       %%%
%%% %%% %%% %%% %%%%% %%% % %%%%% %%%%%%% %%% %%%%% %%%%% %%%%%%%%% %%% %%% %%%%% % %%% %%% %%%%%%%%%
%       %%% %         %%% %       %%% %%%     %%%             %     %%%       %%% % %%%       %%%%%%%
% %%% %%%%% % %%%%% %%%%% %%%%% %%%%% %%% %%% %%% % %%%%%%%%% % %%% %%%%% %%%%%%% %%%%% %%%%% %%%%%%%
% %%% %%%     %   %   %%% %%%%% %%%       %%% %%% % %%%%%%%%% %   %   %%% %%%%%     %%%     %   %%% %
%%%%%%%%%%% %%% % %%% %%% %%%%% %%%%% %%% %%% %%% %%%%%%%%%%% % %%%%% %%% %%%%%%%%% %%%%%%% %%% %%% %
%%% %%% %%% %%% %   % %%% %       %%% %%% %   %%%   %     %%% % %%%%% %%% %%%%%%%%% %%%%%   %   %%% %
%%% %%% %%% %%% %%% % %%% %%% %%%%%%%%%%% %%%%%%%%% % %%% %%% %%%%%%% %%% %%%%%%%%% %%%%%%% % %%%%% %
%%%     %%% %%% %%%   % % %%% %%%%% %%%   %%%%%     % %%% %%% %       %%%   %%%     %%% %%% %       %
%%% %%% %%% %%% %%%%%%% % %%% %%%%% %%%%% %%%%%%% %%% %%% %%% % % %%% %%%%% %%%%% %%%%% %%%%%%% %%%%%
%   %   %%%   %       % % %     %                 %   %%% %%%   % %%%   %%%   %%%         %%%%%   %%%
%%%%% %%%%%%% %%%%%%% % % % %%% %%% %%% %%%%% %%%%% %%%%% %%%%%%% %%%%%%%%%%% %%%%% %%%%% %%%%%%% %%%
%     %%%%%       %   %     % % %%%   %   %%% %%% % %%%%%     %   %%%%%%%     %%%%% %               %
% %%% %%%%%%% %%%%% %%%%%%%%% % %%%%%%%%% %%%%%%% % %%%%% %%%%% %%%%%%%%%%%%% %%%%% % %%% %%%%%%% %%%
% %%%       % %%%%%     %     %     %%%%% %%%%%%% %     %     % %%%%%%%     %   %S% % %%% %%%%%   %%%
% %%%%%%%%% %%%%%%%%%%% % %%%%%%%%% %%%%% %%%%%%% %%%%% %%%%% % %%%%%%% %%% %%%%% % %%%%%%%%%%% %%%%%
%   %%%%%   %%%%%       %     %%%%%   %%%   %%%     %%% % %%%   %%%%%%% %%% %%%%%   %%%%%%%%%%% %   %
% %%%%%%%%% %%%%% %%%%%%% %%% %%%%%%% %%%%% %%%%%%% %%% % %%%%%%%%%%%%% %%% %%%%%%% %%%%%%%%%%% %%% %
% %%%   %%% %     %   %   % %     %%% %%%   %%%%%%%         %%%%%%%%%%% %%%   %%%   %%% %     % %   %
% %%% % %%% %%% %%% %%% %%% %%% %%%%% %%% % %%%%%%%%%%%%%%%%%%%%%%%%%%% %%%%% %%%%%%%%% % % %%% % % %
%   % %         %%%     %   %%%       %%% % %%%   %%%%%%%%%%%       %%%   %%%   %%%%%     % %%%   % %
%%% %%%%%%%%%%%%%%% %%%%% % %%%%%%%%%%%%% %%%%%%% %%%%%%%%%%% %%%%% %%% %%%%% % %%%%% %%%%% %%% %%% %
%%%       %%%%%   % %%%   %   %%% %%%         %%%     %%%%%   %%%%% %   %%%%% % %     % %%%     %%% %
%%% %%%%% %%%%%%% % %%%%% %%% %%% %%%%% %%% % %%%%% % %%%%% %%%%%%%%% %%%%%%%%% % %%%%% %%%%%%%%%%%%%
%%% %%%%% % %%%%%         % %       %%% %%% %   %%% %   %%% %%%%% %%%   %%%%%%%   % %%%     %%% %%%%%
%%% %%%%% % %%%%%%%%%%%%%%% %%%%% %%%%% %%%%% % %%% %%% %%% %%%%% %%% %%%%%%%%%%%%% %%% %%% %%% %%%%%
%       % %     %%%%%   %         %%%%%   %%% %     %   %%%       %%% %%% %%%     %     %   %     %%%
% %%% %%% %%% %%%%%%%%% % %%%%%%%%%%%%%%% %%% %%%%% %%% %%%%%%% %%%%% %%% %%% %%% % %%%%% %%% % %%%%%
% %%% %%% %%% %%%   %%%   %%%%%%%           % %%%%% %%%   %%%   %%% % %%%     %%%   %     %%% % %%% %
% %%%%%%% %%% %%% %%%%% %%%%%%%%% %%%%%%%%%%% %%%%% %%% %%%%% %%%%% % %%% %%%%%%% %%% %%%%%%% % %%% %
% % %%%%% %%%     %%%%%     %     %%%%%%%       %%% %%% %%%   %%%%%       % %%% % %%%     %   %     %
% % %%%%% %%%%% % %%%%%%%%% % %%%%%%%%%%% % %%% %%%%%%% %%%%% %%%%%%%%%%%%% %%% % %%%%%%% % % %%%%% %
% %     % %%%   % %%% %%%   % %           % %%% %   %     %%%   %%%%%       %%%   %%%%%%%   % %%% % %
% % %%% % %%% %%%%%%% %%%%% % % % %%% %%%%%%%%%%% % % %%%%%%%%% %%%%%%% %%% %%%%%%%%%%%%%%% %%%%% % %
%   %%% % %             %%% % % % %%% %%%%%       % % %%%%%     %%% %%% %     %%%%%     %%% %%%%% % %
%%% %%%%% %%% %%%%% %%% %%% %%% %%%%% %%%%% %%%%%%% %%%%%%% %%%%%%% %%% %%% %%%%%%% % %%%%% %%%%% % %
%   %%%   %%% %%%%%   % %     % %%%%% %     %     %   %%%%%   %%%       %%% %%%%%%% %   %%%   %%%   %
%%%%%%% %%%%%%%%%%%%% %%% %%% % %%%%%%% %%%%%%% %%%%% %%%%% % %%% %%% %%%%%%%%%%%%% %%% %%% %%%%%%% %
%%%%%   %   %%% %%%%%     %%%       %%%       % %%%%%   %   %   % %%%     %%%%%%%%% %%% %   %%% %%% %
%%%%%%% %%% %%% %%%%%%% %%%%%%% %%%%%%%%% %%% % %%%%%%% % %%%%% % %%%%%%% %%%%%%%%%%%%% % %%%%% %%%%%
%       %%%         %%%   %%%   %%%%%     %%%   %   %%%   %%% %     %%%%%   %%%%%%%%% %   %     %%%%%
%%% % %%%%%%%%%%%%% %%% %%%%%%%%%%%%% %%% %%%%% % %%%%% %%%%% %%%%%%%%%%% % %%%%%%%%% % %%%%% % %%%%%
%%% %       %%%%%%%     %%% %%%%%     %%%   %%% % %%%       %     %%%     % %%% %%%%% %     % % %%% %
%%%%% %%%%% %%%%%%% %%%%%%% %%%%% %%%%%%%%%%%%% % %%%%% %%% % %%% %%%%%%% %%%%% %%%%% %%%%% % %%%%% %
%%%%% %     %%%%%%% %%%%%   %%%%%       %%%%%     % %%% %%%   %%%   %     %%%           %%% %       %
%%%%%%% %%% %%%%%%% %%%%% %%%%%%%%%%% %%%%%%%%%%% % %%%%%%%%%%%%%%% % %%%%%%%%%%% %%% %%%%% %%% %%%%%
%       %%%   %%%%% %%%       %%%   % %%%   %%%%%     %%% %%%%%%%%% % %%%%%       %%% %%%%%   %     %
% %%%%% %%%%% %%%%%%%%%%% %%% %%% %%% %%%%% %%%%%%%%%%%%% %%%%%%%%%%% %%%%% % %%% %%% %%%%%%% %%%%% %
% %     % %%% %%%   %%%%% %%%   %     %       %%%%%%%%%     %%%%% %%%       % %%% %%%   %%%%%       %
% % %%%%% %%%%%%% % %%%%% %%%%% % %%%%%%% %%% %%%%%%%%%%%%% %%%%% %%% %%%%% %%%%%%%%%%%%%%%%%%%%%%% %
% %     %   %%%   % %%%   %   %   %       %%% %                   %%%   %%% %   %%%%%%%%%%%%%%%   % %
% %%%%% %%% %%% %%% %%% %%% %%%%%%% % %%%%%%%%% % %%%%%%% %%% %%% %%%%% %%%%% % %%%%%%%%%%%%%%% % % %
% %%%%% %%% %%% % %   %     %%%%%   % %%%%%     % %%%%%%% %%% %%% %%%     %   %   %%% %   %%%   %   %
% %%%%% %%% %%% % % %%%%% %%%%%%% %%% %%%%%%% % %%%%%%%%%%%%%%%%% %%% % %%% %%% %%%%% % % %%% %%%%%%%
% %%%     %   %   %     % %%% %%% %%%   %%%   % %%% %   %%%%%%%   %   % %   %%%   %%%   %     %   %%%
% %%%%%%% %%% %%% %%% %%% %%% %%%%%%% %%%%% %%% %%% % % %%%%%%%%% % % %%% %%%%%%% %%% %%% %%% % %%%%%
%   %%%       %%% % %     %           %%% %   % %%%   % %   %%%%%   % %%% %%%%%   %   %%% %%%   %%%%%
% % %%%%%%%%% %%% % %%%%%%% %%%%% %%% %%% %%% %%%%% %%% % % %%%%%%% %%%%% %%%%% %%% %%%%%%%%%%% %%%%%
% % % %%%%%%% %%%       %     %%% %%% %%%   %       %%% % %   %     %%% % %%%       %   %%% %%% %%%%%
% % % %%%%%%%%%%%%%%%%% %%%%% %%% %%% %%% %%%%%%%%%%%%% % %%% %%%%%%%%% % %%%%% %%% %%% %%% %%%%%%%%%
% %   %%% %%%%%%%%%   % %%%   %%% %   %     %%%       %     % %%%%%%%%%   % %%% %%% %%%   %   %%% %%%
% %%%%%%% %%%%%%%%%%% % %%%%% %%% % %%%%%%% %%% %%%%%%%%%%%%% %%%%%%%%%%% % %%%%%%%%%%% %%% % %%% %%%
%         %%%   %%%%%     %%% %   %           %         % %%%     %%%%%%%   %%%%%%%%%   %%% %       %
% %%%%%%% %%%%% %%%%%%%%% %%%%% %%%%%%%%%%%%% %%% %%% % % %%%%%%% %%%%%%%%% %%%%%%%%%%% %%% % %%% %%%
% %   %%%   %%% %%%%%%% %       %   %         %%%   % %   %%%%%     %%%     %   %%%%%%%     % %   %%%
% %%% %%%%% %%% %%%%%%% %%%%% %%% % % %%%%%%%%%%%%%%% % %%%%%%% %%%%%%%%% %%% %%%%%%%%% %%%%% %%% %%%
%   %     % %%%         %%%%% %%% %   %       %%%%%%% % %%%   % %%%%% %%%     %%%       %%%%% %%%   %
%%% % % %%% %%% %%%%% %%%%%%%%%%% %%%%% % %%%%%%%%%%% % %%%%% % %%%%% %%%%%%% %%%%%%% %%%%%%% %%%%% %
% %   % %%% %       % %%%   %%%   %     % %%%%%   %%% %       %             % % %%%%%     %%% %%%%% %
% %%%%% %%% % %%%%%%% %%% %%%%% %%% %%% % %%%%% %%%%% %%%%%%% %%%%%%%%%%% %%% % %%%%% %%%%%%% %%%%% %
% %     %%%     %%%%%     %%%%% % % %%% % %%%%%       %%% %%% %%%%%%% %%% %%% % %%%   %%%%%     %%% %
% % %%%%%%%%%%%%%%%%% %%% %%%%% % % %%%%% %%%%% %%%%% %%% %%% %%%%%%% %%% %%% % %%%%% %%%%% %%% %%% %
% % %%%%%   %%%%%%%%% %   %%% % %     %%%         %   % %     %%%%%%% %   %%%       % %%%%%   % %   %
% % %%%%%%% %%%%%%%%%%% %%%%% % %%%%% %%%%%%%%%%% % %%% % %%%%%%%%%%% % %%%%%%%%%%% %%%%%%%%%%% %%% %
%   % %%%%%   %%%%%     %%%%% %   %     %       % % %%% %             %   %%% %%%         %%%%% %%% %
% %%% %%%%%%% %%%%%%% %%%%%%% %%% %%%%%%% %%%%% %%% %%% %%%%%%% %%%%%%%%% %%% %%%%%%%%%%% %%%%% %%%%%
%     %%% %%%   %%%%%           %     %   %%%   %%%   %   %%%%% %%%%%%%%% %     %%%   %   %       %%%
%%%%% %%% %%% %%%%%%%%%%% %%% %%%%%%% % %%%%%%% %%% % %%% %%%%% %%%%%%%%% % % %%%%% % % %%% % %%% %%%
%   % %   %%% %%%%%   %%% %%% %%%%%%%   %%%%%%%   % %   %   %     %%%       %       %       % %%%   %
% %%% % %%%%% %%%%% % %%%%%%% %%%%%%%%%%%%%%%%%%% %%%%% %%% % %%%%%%% %%%%%%%%%%%%%%%%%%%%%%% %%%%% %
%   %   %%%       % %   %%%       %%%%%%%%%%%     %%%%% %%%     %%%%% %%%%%%%%%   %%%%% %%%%% %%%   %
% % % %%%%%%% %%% % %%%%%%%%%%% %%%%%%%%%%%%%%% %%%%%%% %%%%% %%%%%%%%%%%%%%%%%%% %%%%% %%%%%%%%% %%%
% %   %%%     %%%   %%%%%%%%%%% %%%     %%%%%%% %%%       %%% %%%%%%%%% %     %%%           %%%     %
% %%%%%%% %%%%%%%%% %%%%%%%%%%% %%%%% %%%%%%%%% %%%%%%% % %%%%%%%%%%%%% % % %%%%% %%%%%%%%% %%%%% %%%
%   %   % %%%%%%%   %   %%%           %%% %     %%%%%%% %   %%% %%%%% %   %       %%%   %%%   %%% %%%
%%% % % % %%%%%%% %%% % %%%%%%% % %%%%%%% % %%% %%%%%%%%% %%%%% %%%%% % %%% %%% %%%%% % %%%%% %%%%%%%
%   % %       %%%     % %%%     % %%%%%%%   %%%       %%% %%%%%     %   %%% %%% %%%   %   %%%   %%%%%
%%% % %%% %%% %%%%%%%%% %%% %%%%% %%%%%%%%% %%%%%%%%% %%% %%%%% % %%% %%%%%%%%% %%% %%%%% %%% %%%%%%%
%%% % %   %%% %%%%% %%% %%%   %         %%%   %%%%%%%   % %%%%% % %%%   %%%%%   %%% %%%   %   %%%%% %
%%% % %%%%%%%%%%%%% %%% %%%%% %%%%% %%%%%%% %%%%%%%%%%% % %%%%%%% %%% %%%%%%% %%%%% %%%%% % % %%%%% %
%%% % %%%%% %%%%% %     %%% %   %   %%%%% % %%%%%%%%%%%     %%%%%     %%% %%%   %%%   %%%   % %%%%% %
%%% % %%%%% %%%%% % %%%%%%% %%% % %%%%%%% % %%%%%%%%%%% %%% %%%%%%%%% %%% %%% %%%%% %%%%%%%%% %%%%% %
%           %%%     %       %%% %   %%%   %     %%%%%%% %%% %%%%%%%%%   % %%% %%%     %   %       % %
%%% %%%%% %%%%% %%% %%%%%%% %%% %%%%%%% % %%%%% %%%%%%% %%% %%%%%%%%%%% % %%%%%%% %%% %%% % %%%%% % %
%%% %%%%% %%%%% %%%   %%%   % %         % %%% % %   %%% %%% %%%%% %%%%%     %%%   %   %%%     %%%   %
%%% %%%%% %%%%%%%%%%% %%% % % %%%%% %%% %%%%% % %%% %%%%%%%%%%%%% %%%%%%%%%%%%%%%%% %%%%%%%%% %%%%% %
%     %%% %%%%%%%%%%% %%% % %   %%%   %   %           %%% %%%%%       %   %%%%%     %%%%%%%     %%% %
% %%% %%%%%%%%%%%%%%% %%% % % %%%%%%% %%% % %%%%% %%% %%% %%%%% %%%%% % % %%%%% %%%%%%%%%%% %%% %%% %
% %%% %%%%%%%%%%%%%       %   %%%     %%%     %%% %%%           %%%%%   %       %%%%%%%     %%% %%% %
%%%%%%%%%%%%%%%%%%%%%%%%%%%%%%%%%%%%%%%%%%%%%%%%%%%%%%%%%%%%%%%%%%%%%%%%%%%%%%%%%%%%%%%%%%%%%%%%%%%%%
