%%%%%%%%%%%%%%%%%%%%%%%%%%%%%%%%%%%%%%%%%%%%%%%%%%%%%%%%%%%%%%%%%%%%%%%%%%%%%%%%%%%%%%%%%%%%%%%%%%%%%
%%%   %%% %%%           %%%%%           %%%%%     %   %%%%%%%%% %%%%% %%%%%%% %%%   %%%     %   %%% %
%%%%% %%% %%% %%%%%%% %%%%%%% %%%%% %%% %%%%%%%%% % % %%%%%%%%% %%%%% %%%%%%% %%%%% %%% % % % %%%%% %
% %%%         %%%%%%% %%%%%   %%%%% %%%   %%%%%%%   % %%%   %%% %       %%%     %%%     % %   %%%%% %
% %%% %%% %%%%%%%%%%% %%%%% % %%%%%%%%%%%%%%%%%%% %%% %%% %%%%% % % %%% %%% %%%%%%% %%% % %%%%%%%%% %
%   % %%% %     %%%     %   %     %%%%%%%%% %%%     %     %%%%% % % %       %%%   % %%% % %%%%%%%%% %
% %%% %%%%% %%% %%% %%% % %%%%%%% %%%%%%%%% %%% %%%%% % %%%%%%% % % %%%%%%% %%% % % %%%%% %%%%%%%%% %
% %%% %%%%% %%%     %%%   %     % %%%%%%%     %   %   % %%%%%     %   %%%%% %%% %     %%%     %%%   %
% %%% %%%%% %%%%% %%%%%%%%%%% %%% %%%%%%% %%%%%%% % %%%%%%%%% %%%%%%% %%%%%%%%% %%%%%%%%%%%%% %%%%% %
%       %   %   % %%%%%%% %%% %   %%%%%%% %%%%%   %         % %%%%%     %           %%%       %%%%% %
%%%%%%%%% %%% % % %%%%%%% %%% % %%%%%%%%% %%%%%%% %%%%%%% %%% %%%%% %%%%% %%%%%%%%%%%%%%% %%%%%%%%% %
%%%%%   % %%% %   %%%         % %   %%%%%   % %%% %   %%%     %%%%% %%%%% %%%%%%%%%%%%%%%         % %
%%%%% % % %%%%% %%%%%%% %%% % % %%% %%%%% % % %%% % %%%%%%%%%%%%%%% %%%%% %%%%%%%%%%%%%%% %%% %%% % %
%%%   %   %%%%%     %%% %%% % %     %%%%% %     %   %%%   %%%%% %%%     % % %%%%% %%%%%   %   %%%   %
%%% %%%%%%%%%%%%%%% %%%%%%% %%%%%%% %%%%% %%%%%%%%% %%%%% %%%%% %%% %%% % % %%%%% %%%%%%%%% %%%%% %%%
%       %%%   %%%%% %%%%%%%       % %%%     %%%     %     %%%%%   %   % %       %   %%%%%%% %     %%%
%%%%%%% %%% %%%%%%%%%%%%%%%%%%% % % %%% %%% %%% %%%%% %%%%%%%%%%% %%% %%%%%%%%% % % %%%%%%% %%% %%%%%
%%%%%%% %%% %%%   %%% %%% %%%%% %   % % %%%     %%%%%       % %%%   %       %%%   %     %%% %%% %%% %
%%%%%%% %%% %%% % %%% %%% %%%%% %%% % % %%%%%%%%%%%%% %%% % % %%%%% %%%%%%% %%%%% %%% %%%%% %%% %%% %
%       %       %     %%%   %%% %%%   %       %%%%%     % %       %   %     %%%   %%% %     %%%     %
%%% %%% % %%% %%%%%%% %%% % %%%%%%%%% %%%%%%% %%%%%%%%%%% %%%%%%% %%% % %%%%%%% %%%%%%% %%%%%%%%% %%%
%%% %%%   %%%   %%%%%     %   %%%       %%% % %%% %%%%%   %%%%%%%   % %         %%% %%% %%%       %%%
%%% %%%%%%%%%%% %%%%% %%%%% %%%%%%% %%%%%%% % %%% %%%%% %%%%%%%%%%% % %%%%%%%%%%%%% %%% %%%%% %%%%%%%
%       %%%%%%% %     %%% % %%% %%%   %%%     %%%       %               %%% %%%%%   %%%   %%%       %
% %%%%%%%%%%%%% % %%%%%%% % %%% %%%%% %%% %%%%%%%%% %%%%% %%%%%%%%%%%%% %%% %%%%% % %%% % %%% %%%%%%%
%   %   % %%%   % %     %     % %%%%%   % %%%   %%% %%%       %%%%% %%% %%% %%%   %     % %%% %%%%%%%
% %%% % % %%%%% % % %%% % %%% % %%%%%%%%% %%% % %%% %%% %%%%%%%%%%% %%% %%% %%% %%% %%% %%%%%%%%%%%%%
% %%% %         % % %%% % %%%   %%%%%%%%% %%% %     %%% %%%%%%%%%%% %%% %   %%% %%% %%% %%% %%%     %
%%%%% %%%%%%%%%%%%% %%% %%%%%%% %%%%%%%%% %%% % %%%%%%%%%%%%%%%%%%% %%% % %%%%%%%%% %%%%%%% %%% %%%%%
%%%     %%%%%%%%%   %%%   %%%     %%%%%%% %   %     %%%%%%%   %     %%% % %%%%%%%%%   %%%   %%% %   %
%%% %%% %%%%%%%%% %%%%%%% %%%%%%% %%%%%%% %%%%%%%%% %%%%%%% %%% %%% %%% % %%%%%%%%%%% %%%%% %%% % % %
%     %       %%% %%%       %%%   %%%%%%% %%%%%       %%%%% %%% %%%   %   %%%%%     %   %%%     % % %
% %%%%% %%% %%%%% %%% %%% %%%%% %%%%%%%%% %%%%% %%% %%%%%%% %%% %%% %%%%% %%%%% %%% % % %%% %%% % % %
% % %%% %%%         % %%% %%%%% %%%%%%%   %%%   %%% %%%%%%%       %     % %     %%%   % %%% %%%   % %
% % %%% %%%%%%%%%%%%% %%%%%%%%% %%%%%%% %%%%% %%%%% %%%%%%%%%%% %%%%%%% % % %%% %%%%% %%%%% %%% %%% %
% % %%%   %%%     %%%   %%%%%     %%%   %     %%%%%   %%%%%%%%% %%%%%%%   %   %   %%% %%%   %%% %%% %
% % %%%%% %%% %%% %%% %%%%%%% %%%%%%% %%%%% % %%%%% %%%%%%%%%%%%%%%%%%%%%%%%% % %%%%%%%%% %%%%%%%%% %
%   %%%%% %   % % %%%   %%%   %%%%% %     % %   %%% %%% %%%   %%%   %%%%%%%%% % %%% %%%   %     %   %
% %%%%%%% % %%% % %%%%% %%%%%%%%%%% %%%%% % %%%%%%%%%%% %%% %%%%%%% %%%%%%%%% %%%%% %%% %%% %%% %%% %
% %%% %%%   %     %%% %   %%%%%   %   %   % %%%%% %%%       %%% %%% %       %           %%% %%%     %
%%%%% %%%%%%% %%%%%%% % %%%%%%% % % % % %%% %%%%% %%% % %%% %%% %%% % %%%%% %%%%% %%% %%%%% %%% %%%%%
%%%     %%%%%         % %%%%%   %   % %   %       %%% % %%% %   %%%   %%%     %%% %%% %%%%% %   %%%%%
%%% %%% %%%%%%% %%%%%%% %%%%%%% %%%%%%%%% %%% %%% %%% %%%%%%% % %%%%%%%%% %%%%%%%%%%%%%%%%% % %%%%%%%
%     %     %%% %           %%% %%%%%%%   %%% % %     %%%%%   %     %%%         %%% %%%     % %%%%%%%
% %%% %%%%%%%%%%% %%%%%%% %%%%% %%%%%%% %%%%% % %%%%% %%%%% %%% %%% %%%%%%%%% %%%%% %%%%% %%%%%%%%%%%
% %%%     %%%     %%%%%%% %%%%% %%%   % %   %   %%% %         % %%%         % %%%         %%%%%%%%%%%
% %%%%%%% %%% %%%%%%%%%%% %%%%% %%% % % % %%%%% %%% %%% %%%%% % %%%%% %%%%% % %%% %%%%%%% %%%%%%%%%%%
%   %%%   %           %%% %   %     %   % %%% % %%% %%% %%%%% %   %%% %%%%%   %%% %%%%%%%     %%%%%%%
%%% %%% %%% %%%%% %%%%%%% %%% % %%%%%%%%% %%% % %%% %%% %%%%% % %%%%% %%%%%%%%%%% %%%%%%%%% %%%%%%%%%
%     % %%%   %%%     %%%     %     %%%%%   %   %   %%% %%%   % %%%%% %%% %%%%%   %%%   %%% %%%%%%%%%
% %%%%% %%% %%%%%%%%% %%%%%%% %%% %%%%%%% %%% %%% %%%%%%%%% %%% %%%%%%%%% %%%%% %%%%% %%%%%%%%%%%%%%%
% %%%   %%% %%%   %%% %     % %   %%%%%   %   %%% %%% %%%%% %%%   %%%%%   %%%   %%%%%     %%% %%%%%%%
%%%%% % %%% %%%%% %%% % %%% %%% %%%%%%%%% % %%%%% %%% %%%%% %%% % %%%%%%% %%%%% %%%%%%%%% %%% %%%%%%%
%%%   % %%% %     %%%   %%%     %%%%%%%%% %   %         %%%   % % %%%%%%%   %%%     %%%%% %%%       %
%%% %%%%%%% % %%% %%%%% %%%%%%% %%%%%%%%% %%% %%%%% %%%%%%%%%%% %%%%%%%%% %%%%% %%% %%%%% %%% %%% %%%
%     %%% %   % %   %%%   %%%%%   %%%%%%%     %%%   %%%%% %%%   %%%   %%%     %   %       %%% %%% %%%
%%%%% %%% %%%%% % %%%%%%%%%%%%%%%%%%%%%%% %%%%%%% % %%%%% %%% %%%%% % %%%%% %%% %%% %%%%%%%%%%%%% %%%
%%%             % %%% %%%%%   %%%%%   %           % %%%%%     %%%   %   %%%   % %%% %%%     %%% %   %
%%% %%%%%%%%% %%% %%% %%%%% % %%%%% % % %%% %%%%%%%%%%%%% %%% %%% %%%%% %%%%% % %%% %%% %%% %%% % % %
%%%       %   %%% %     %   % %%%   % % %%% %       %     %%% %%%   %%% % %%%     %     % %       % %
%%% %%%%% %%%%%%% % %%% %%% %%%%% % %%% %%%%% %%%%% % %%% %%%%%%% % %%% % %%% %%%%%%% %%% %%% %%%%% %
%%%   %%%         % %%%     %%%   %       %   % %     %%%   %%%   % %     %%%   %%%%%     %%% %%%   %
%%%%% %%%%%%%%%%%%% %%% %%%%%%% %%%%%%%%%%% %%% % %%% %%% %%%%%%% % %%%%%%%%%%% %%%%%%%%% %%%%%%% % %
%   % %       %%%%%   % %%%%%%% %%% %%%%%   %%%   %%% %%% %%%%%%% %     %%% %%% %%% %%%     %%%%% % %
% %%% %%%%%%% %%%%%%% %%%%%%%%% %%% %%%%% % %%%%%%%%%%%%%%%%%%%%%%%%% % %%% %%% %%% %%%%%%%%%%%%% %%%
% %%% %%%%%%% %       %%%   %         %   %   %%%   %%%%%     %%%%%%% %     %%% %%% %%%     %%%%% %%%
% %%% %%%%%%% % %%% %%%%% % % %%%%%%% % %%%%%%%%% % %%%%% %%% %%%%%%%%%%% %%%%% %%% %%% %%% %%%%% %%%
% %   %%%%%%% % %%%       %     %%%%% %   %%%%%   %   %%% %%% %%%       %     % %   %%% %           %
% % %%%%%%%%% % %%%%%%%%%%%%%%% %%%%%%%%% %%%%% %%%%% %%% %%% %%% %%%%% % % %%% % %%%%% %%%%%%% %%% %
%   % %%%%%       %%%%%       %     %%%   %%%   %%%%% %   %     % %%%%% % %       %%%   %%%%%   %%% %
% %%% %%%%%%%%% %%%%%%% %%%%% %%% %%%%% %%%%% %%%%%%% % %%%%%%% % %%%%% %%%%%%%%%%%%%%% %%%%%%% %%%%%
%       %%%%%%% %%%     %%%%%   % %%%           %%%   %     %     %%% %         %%%%%%%     %%%   %%%
% %%%%%%%%%%%%%%%%%%% %%%%%%%%% %%%%% %%%%%%%%%%%%% %%%%%%% %%%%% %%% %%% %%%%% %%%%%%%%% %%%%% %%%%%
% %%%%%%%     %%%     %   %%%     %   %       %%% % %%%%% % %%%%% %%% %%% %%%   %%%%%%%%% %%%%% %%%%%
% %%%%%%%%% %%%%%%% %%% % %%%%%%% %%% % %%%%% %%% % %%%%% % %%%%%%%%% %%%%%%% %%%%%%%%%%% %%%%%%%%%%%
%       %%% %%% %%%   % % %%%%%     %   %%%%% %%% %   %%% %S%   %%%%% %%%%%   %%%         %%%%%%%   %
% %%%%% %%% %%% %%%%% % %%%%%%%%%%% %%%%%%%%% %%% %%% %%% %%%%% %%%%% %%%%% %%%%%%%%%%%%% %%%%%%%%% %
% %%%                 % %%%   %%%%%         %     %%%           %%%   %%% % %   %%%       % %%%%%   %
% %%%%% %%% %%%%% %%%%% %%%%% %%%%%%%%%%%%% % %%% %%%%% %%%%% %%%%%%% %%% % %%% %%% %%%%% % %%%%% %%%
% %%%%% %%% %%%%% %%%   %%%%%     %%%%% %   % %%%   %%%   %%%     %%%     %   %     % %%% % %     %%%
% %%%%% %%%%%%%%%%%%% % %%%%% % %%%%%%% % %%%%%%%%%%%%%%% %%%%% %%%%% %%%%%%% % %%%%% %%% % % %%% %%%
%   %%% %%%%%   %%%   % %%%%% % %%%     % %     %   %       %%% %     %   %   % %%%         %   %   %
% %%%%%%%%%%% %%%%% %%% %%%%%%% %%%%%%% % % %%% % % %%%%%%% %%% % %%% % % % %%% %%%%% %%% %%% %%% %%%
% %%%%%%%     %%%   %       %     %%%%%     %     %     %%% %%%   %%% % %   %%%   %%% %%% %%% %%% %%%
% %%%%%%% % % %%%%% %%% %%% % %%%%%%%%%%% %%% %%%%% %%% %%% %%%%%%%%% % %%%%%%% % %%%%%%%%%%% %%% %%%
% % %%%%% % % %%%   %%% %%%  !%%%%%%%%%%% %%%   %%% %%% %%% %     %   %   %%%%% %     %%%       %   %
% % %%%%%%% % %%% %%%%%%%%%%% %%%%%%%%%%% %%% %%%%%%%%% %%% %%%%% % %%%%% %%%%% %%%%% %%% %%%%% %%% %
%   %%%%%%% %     %%%%%%%   %   %%%%%%%%% %%% %%%%%%%%%   %   %%% % %%%   %%%%%   %%% %%% %%%%% %%% %
%%%%%%%%%%% %%% %%%%%%%%%%% % %%%%%%%%%%%%%%%%%%%%%%%%%%% %%% %%% % %%%%% %%%%% %%%%% %%% %%%%%%%%% %
%%%%%%%%%%%   % %%%%% %%%%%   %%%       %%%%%%%%%%%%%     %       % %%%%% %%%   %%%     % %   %%%   %
%%%%%%%%%%%%% %%%%%%% %%%%%%% %%% %%%%% %%%%%%%%%%%%% %%%%%%%%%%%%% %%%%% %%% %%%%%%%%% % % %%%%%%% %
%%%%%%%%%%%%%   %%%%%   %%%%% %%% %   %   %%%   %%%       %%%%%%%%%   %%% %%%   %%%%%%%     %%%%%   %
%%%%%%%%%%%%%%% %%%%% %%%%%%% %%%%% % % % %%% %%%%% %%%%% %%%%%%%%% %%%%% %%% %%%%%%%%%%%%%%%%%%% % %
%%%%%%%%%%%%%%%     %     %%%   %%% %   % %%% %%%     %%%   %%%     %%%%% %%% %%%       %%%   %   % %
%%%%%%%%%%%%%%%%%%% % % %%%%%%% %%% %%%%% %%% %%% %%% %%%%% %%%%% %%%%%%% %%%%%%% %%%%% %%% % % % %%%
%%%%%%%%%%%%%%%%%%%   %   %   % %%%   %%%   %     %%%   %%% %%%%% %%%   %   %%%   %%%   %   % % % %%%
%%%%%%%%%%%%%%%%%%% %%%%% % % %%%%% % %%% %%% %%% %%% %%%%% %%%%% %%% %%%%% %%% %%%%%%% % %%% %%% %%%
%%%%%%%%%%%%%%%   %   %%%   %       %   % %%% %%% %%% %%%%%           %%% % %   %%%%%%%   % % %%%   %
%%%%%%%%%%%%%%%%% %%% %%% %%%%%%%%% %%% %%%%% %%%%%%% %%%%% %%%%% %%% %%% % % %%%%%%%%%%%%% % %%% %%%
%%%%%%%%%%%%%%%%%     %%%       %%% %%%         %%%     %%% %%%   %%% %%%     %%%%%%%%%%%         %%%
%%%%%%%%%%%%%%%%%%%%%%%%%%%%%%%%%%%%%%%%%%%%%%%%%%%%%%%%%%%%%%%%%%%%%%%%%%%%%%%%%%%%%%%%%%%%%%%%%%%%%
