%%%%%%%%%%%%%%%%%%%%%%%%%%%%%%%%%%%%%%%%%%%%%%%%%%%%%%%%%%%%%%%%%%%%%%%%%%%%%%%%%%%%%%%%%%%%%%%%%%%%%
%%%%%%%%%%%     %%%%%    !    %%%       %%%%%%%%%               %%%   %%%%%   %%%   %%%   %%%%%%%%%%%
%%%%%%%%%%% %%% %%%%% %%% %%% %%%%% %%% %%%%%%%%%%%%%%% %%%%%%% %%% %%%%%%% %%%%%%% %%%%% %%%%%%%%%%%
%%%%%%%%%%% %%%   %%% %   %%%       %%% %%%%%%%%%%%%%   %   %%%     %%%%%     %%%   % %%%   %%%%%%%%%
%%%%%%%%%%% %%%%%%%%% % %%%%%%%%%%% %%%%%%%%%%%%%%%%% %%% % %%%%% %%%%%%% %%% %%% % % %%%%% %%%%%%%%%
%%%%%%%%%%% %%%%%%%   % %%%         %%%%%%%%%%%%%%%%%     %   %%% %%%%%%% %%%     %         %%%%%%%%%
%%%%%%%%%%% %%%%%%% %%%%%%% %%%%%%%%%%%%%%%%%%%%%%%%%%%%% %%% %%%%%%%%%%%%%%%%%%% %%%%%%%%% %%%%%%%%%
%%%%% %       %%%   %%%%%%%   %   %%%%%%%%%%%%% %%% %%%%% %     %%%     %%%       %%%   %   %%%%%%%%%
%%%%% % %%% %%%%% % %%%%%%%%% %%% %%%%%%%%%%%%% %%% %%%%%%% %%% %%%%% % %%% %%%%%%%%%%% % %%%%%%%%%%%
%%%     %%%   %   % %       %     %%%%%%%%%     %%%   %%%%% %%%       % %%% %           %     %%%%%%%
%%% %%%%%%% % %%%%% % %%%%% %%% %%%%%%%%%%% % %%%%%%% %%%%% %%%%%%%%%%% %%% % %%% %%% %%%%%%% %%%%%%%
%   %%%%%   %     %     %%% %%% %%%%%%%%%%% %     %%%       %%%%%%%%%   %   % %%% %%% %%% %%% %%%%%%%
% %%%%%%% %%% %%% %%%%% %%% %%%%%%%%%%%%%%%%% %%% %%%%% %%%%%%%%%%%%% %%% %%% %%% %%% %%% %%% %%%%%%%
%     %%% %%%   % %%%%% %%%   %       %%%%%%% %%% %%%%%       %%%%%%% %   %%% %%% %%% %%%     % %%%%%
% %%%%%%%%%%%%% % %%%%%%%%%%% % %%%%% %%%%%%%%%%% %%%%%%%%% % %%%%%%% % %%%%% %%%%%%% %%% %%%%% %%%%%
% %%%%% %%%%%   % %%%%%S    %   %%%%% %%%   %%%%%   %%%%%%% % %%%%%   %   %%% %%%%%%%     %%%   %%% %
% %%%%% %%%%% %%% %%%%%%%%% %%%%%%%%% %%%%% %%%%% %%%%%%%%%%% %%%%%%% %%% %%%%%%%%%%%%%%% %%%%% %%% %
%   %%%   %%% %%%   %%%%%   %%%         %%%   %%%   %   %%%%%   %%%%% %%%     %     %%%%% %%%   %   %
%%% %%%%% %%%%%%%%% %%%%% %%%%% %%%%% %%%%%%% %%%%% % % %%%%% %%%%%%% %%%%%%% % %%%%%%%%% %%% % %%% %
%%%   %%%   %%% %%%       %%%     %%% %%% %%% %%%%%   %   %%%   %       %%%   %   %%%     %%% %     %
%%%%% %%% % %%% %%%%% %%%%%%%%%%% %%%%%%% %%% %%%%%%% % %%%%%%% %%%%%%% %%% %%%%% %%% %%%%%%% %%% %%%
% %%% %   %     % %%% %%%%% %%%%%   %%%%%         %%% % %%%%%%% %%%%%%%     %%%%% %   %%%     %%% %%%
% %%% % %%%%% % % %%%%%%%%% %%%%% %%%%%%%%% % %%% %%%%% %%%%%%% %%%%%%%%% %%%%%%% % %%%%% %%% %%%%%%%
%   % %   %   %     %%%%%   %%%%% %%%   %%% %   %       %%%%%   %%% %%%   %%%%%%%         % %   %%% %
% % % % %%% %%%%%%%%%%%%%%% %%%%% %%%%% %%%%% % % %%% %%%%%%% %%%%% %%%%%%%%%%%%%%% %%% %%% %%% %%% %
% %   % %%%     %%%%% %%%%%             % %%% % % %%% %%%%%   %%%%%   %%%%%%%%%%%%% %%% %%%   %     %
% %%%%% %%%%%%% %%%%% %%%%% %%%%%%% %%% % %%%%% %%%%%%%%%%% % %%%%%%% %%%%%%%%%%%%% %%%%%%% % % %%%%%
% %%%   %%%       %%%         %   % %   %   %%% %%%%%%% %%% %     %%%         %       %%%   %   %%%%%
% %%% %%%%% %%%%% %%%%%%%%%%% % %%% %%% %%% %%% %%%%%%% %%% %%% % %%% %%%%%%% %%%%% %%%%% %%%%%%%%%%%
%   % %%%   %%%     %%%%%%%%%   %%% %%%               %     %%% %     % %%%%%     % %%%   % %%%%%   %
%%% % %%% %%%%% %%%%%%%%%%%%%%%%%%% %%%%%%%%%%% %%%%% %%%%%%%%%%%%%%% % %%%%%%%%% %%%%% %%% %%%%%%% %
%   % %%% %%%   %%%%%       %%%       %%%%%%%   %%%%%   %       %%%%%   %%%   %   %%%%%     %       %
% %%% %%% %%%%%%%%%%% %%%%% %%% %%% %%%%%%%%% %%%%%%%%% % %%%%% %%%%% %%%%% % % % %%%%% %%% %%% %%% %
% %%% %%%   %%%       %         %%% %%%   %%% %%% %%%%%   %%% %     % %%%   %   % %%%%% %%%     %   %
% %%%%%%%%% %%% % %%%%%%%%%%%%%%%%%%%%%%% %%%%%%% %%%%%%%%%%% %%%%% %%%%% % %%%%%%%%%%%%%%%%%%%%% %%%
%   %%%%%%% %   %     %%%   %%%   %%%%%%%   %%%         %%%       % %%%%% %   %%%%%%%%%%%   %%%     %
%%% %%%%%%% % %%% %%% %%% % %%% %%%%%%%%%%% %%% %%%%% %%%%% %%%%% % %%%%% %%% %%%%%%%%%%% %%%%%%%%% %
%   %%% %%% % %%% %%%     % %%%     %%%%%%% %%% %     %     %%% %   %     %%% %%%%%%%%%   %%%%%%%   %
%%% %%% %%% % %%% %%%%% %%% %%% %%% %%%%%%% %%% %%% %%% %%%%%%% %%%%%%%%%%%%% %%%%%%%%% %%%%%%%%%%% %
%%% %%%   %   %%% % %%% %%% %   % %   %     %%% %%% %%%   %     %%% %%%%%       %%%%%     %%%%%%%%% %
%%% %%% %%% %%%%% % %%%%%%% % %%% %%% % %%% %%% %%%%%%%%% % %%% %%% %%%%% %%%%%%%%%%%%%%% %%%%%%%%% %
%   %%%     %%%       %%%%% % %     %   %   %%%   %%% %%%   %   %%%       %   %%%   %%%   %%%%%%% % %
% %%%%%%% %%%%%%%%%%% %%%%% % %%%%% %%% % %%%%%%% %%% %%%%%%% %%%%% %%%%% % %%%%% % %%% %%%%%%%%% % %
% %%% %%% %   %%%%%%%     % %       %%% %               %%%   %%% % % %%% %       %     %%%%%%%   % %
% %%% %%% % % %%%%%%%%%%% % % %%%%% %%%%% %%% % %%%%% %%%%% %%%%% % % %%% %%%%%%% %%%%% %%%%%%% % % %
%       %   %   %%%%%%%   % % %%%     %%% %%% %   %   %%%%% %%%         % %%%%%%%   %%% %%%%%%% %   %
%%%%%%% %%%%%%% %%%%%%%%%%% %%%%%%% %%%%% %%%%% % % %%%%%%% %%%%%%%%% %%% %%%%%%%%% %%% %%%%%%%%% %%%
%%% %%% % %%%%%   %%%%%%%%%   %   % %%%%%   %%% % % %       %%%%%%%   %%%       %%%   % %%%%% %%% % %
%%% %%% % %%%%% %%%%%%%%%%%%% % % %%%%%%%%%%%%%%% %%% %%%%% %%%%%%%%%%%%% % %%%%%%%%% % %%%%% %%% % %
%%%   % %       %%%%%%%   %%% % %   %%%   %   %%%       %%% %%%%%%%%%%%   % %%%%%     %   %   %%%   %
%%% % % %%% %%%%%%%%%%%%% %%% % %%% %%% % % % %%% %%%%%%%%%%%%%%%%%%%%% % %%%%%%%%% %%%%% % % %%% %%%
%   %   %%%   %%%%%%%%%%% %%%   % %     %   % %%%   % %%%%%%%%%%%%% %%% % %%%   %%%   %%%   %   % %%%
% %%% %%%%%%% %%%%%%%%%%% %%% %%% %%%%%%%%% % %%%%% % %%%%%%%%%%%%% %%% %%%%% % %%%%% %%%%%%% %%% %%%
% %%% %%%   % %%%%%%% %%%     %%%   % %%%%% % %   %     %   %%%%%             %   %%%   %%% %       %
% %%% %%% %%% %%%%%%% %%%%% %%%%% % % %%%%%%% % %%% %%% %%% %%%%%%%%% %%% %%%%%%%%%%%%% %%% %%%%%%% %
% %%% %%%           %   %%%     % %   %%%%%   %     %%%       %%%%%%% %%%           % % %     %%%%% %
% %%% %%% %%%%%%%%% % %%%%%%%%% % %%% %%%%% %%%%%%% %%%%%%%%% %%%%%%%%%%%%%%% %%%%% % % % %%% %%%%%%%
% %%% %%% %%%%%%%%%   %%%%%%%%%   %%% %%%   % %%%%% %%%     %     % %%%%%%%%% %%%   % %   % % %%%%%%%
% %%% %%% %%%%%%%%% %%%%%%%%%%% %%%%%%%%%%% % %%%%%%%%% % %%%%%%% % %%%%%%%%%%%%% %%% % %%% % %%%%%%%
% %%% %   %%%   %%% %%% %%%%%   %%%   %%%   %     %%%   % %%% %%% %         %%%%%   %   %%%     %%%%%
% %%% %%% %%% % %%% %%% %%%%%%% %%% % %%% %%% %%%%%%% %%%%%%% %%% % % %%%%% %%%%% % %%% %%%%% %%%%%%%
% %%% %%% %   % %%% %%%     %%% %   % %   %%%   %%%%% %         %   % %%%%% %     % %%% %%%%% %%%%% %
%%%%% %%% % %%% %%% %%% %%% %%%%% %%% %%% %%%%% %%%%% % %%%%% % %%%%%%%%%%% %%% %%% %%%%%%%%%%%%%%% %
%%%   %     %%% %%% %%%   % %%%%% %%%       %%%   %     %%%   %   % %%%   % %%% %     %%%%%%%%%     %
%%% %%%%%%%%%%%%%%%%%%% %%% %%%%% %%%%%%%%%%%%% %%% %%%%%%% %%%%% % %%%%% % %%%%% %%%%%%%%%%%%%%%%% %
%%%         %%%       % %%%   %%%   %%%   %%%%% %   %%% %%% %%%       %%%   %%%%%         %%% %%%%% %
%%%%%%%%%%% %%% %%%%% %%%%%%% %%% %%%%% %%%%%%% % %%%%% %%% %%% %%% %%%%%%% %%%%%%% %%% % %%% %%%%% %
%%% %%%%% %     %   % %%%%%%% %%%   %%%         % %%%   %%% %   %%% %   %%%   % %%% %%% %         % %
%%% %%%%% %%%%%%% % % %%%%%%% %%%%% %%%%% %%%%% % %%%%% %%% %%% %%%%% % %%%%% % %%% %%%%%%%%% %%% % %
%     %%%     %%% % %   %%%     %%%     % %%%%%   %%%%%   % %%% %%%   %   %%%     % %     %   %%%   %
% %%%%%%% %%%%%%% %%%%% %%%%% % %%%%%%% % %%%%%%% %%%%%%% % %%%%%%% %%% % %%%%%%% %%% %%% % %%%%% %%%
% %%%%%   %%%%%         %   % % %%%     % %%%%%%%       % %         % % %   %%%%% %%% %   %   % % %%%
% %%%%%%% %%%%% %%%%%%%%% % % %%%%% %%%%% %%%%%%%%%%%%% % %%%%%%% %%% % %%%%%%%%% %%% % %%%%% % % %%%
%   %%%%%       %     %%% %   %%% %   %%% %%%%%   %%%     %%%%%%% %   % %%%%%%%%%     %   %%% %   % %
% %%%%%%% %%%%%%% %%% %%% %%%%%%% % % %%%%%%%%%%% %%% %%%%%%%%%%% % %%% %%%%%%%%%%%%%%%%% %%% %%% % %
%     %   %   %%% %%%   % %%%%% %   %   %%%   %%%   %   %%%%%%%     %%%         %%%%%   % %   %%%   %
%%%%% % %%% %%%%%%%%% % % %%%%% % %%%%% %%%%% %%% % % %%%%%%%%% %%%%%%% %%% %%%%%%%%%%% % % %%%%%%% %
%%%%% % %       %%%   %     %     %   % %     %   %   %%%%%%%     %%%   %%% %%%%%       % %   % %%% %
%%%%% % %%%%% %%%%% %%% %%% %%%%%%% % % % % %%% %%%%%%%%%%%%%%%%%%%%% %%%%% %%%%%%%%% %%% %%% % %%% %
%     %   %   %%%     % %%% %%%%%%% %   % %     %%%     %%%%%%%%%%%   %%% %     %%%   %%% %   % %   %
%%%%% %%% % % %%%%%%% %%%%% %%%%%%% %%%%% %%% %%%%%%%%% %%%%%%%%%%% %%%%% %%%%% %%% %%%%% % %%% % %%%
%%%%% %   % % %%%%%%% %%%%%         %%% % %%%   %   %%%   %%% %%%%% %     %%%%% %   %%% %   %%%     %
%%%%% % %%% %%%%%%%%% %%%%%%%%%%% %%%%% % %%%%% % % %%% %%%%% %%%%% %%%%% %%%%% % %%%%% %%%%%%% %%% %
%     %   % %%%           %%%%% % %%%       %%% % % %   %%%     %%%   %%%         %%%   %%% %   %%% %
%%% %%%%% % %%% % % %%% %%%%%%% % %%% %%% %%%%% % % % %%%%% % %%%%%%% %%%%% %%%%%%%%% % %%% % %%%%%%%
%%%   %%%   %   % % %%% %%%%%     %%% %%% %%%%%   %   %%%   % %%%%%%%     %   %%%%%   %   %   %%%%%%%
%%%%% %%%%% %%%%% %%%%%%%%%%%%% %%%%% %%%%%%%%% %%%%% %%% %%% %%%%%%%%%%% %%% %%%%% %%% %%% %%%%%%%%%
%   %     %       %%% %%%%% %%% %%%%%   %%% %%% %%% % %   %   %   %%%%% %   %     % %%% %   %%% %%% %
% % % %%% %%%%%%% %%% %%%%% %%%%%%%%%%% %%% %%%%%%% % %%%%% % %%% %%%%% %%% %%%%% % %%% % %%%%% %%% %
% %   %   %%%   %   %         %%%   %%% %%%   %%%   %   %   %             % %%%%% % %%%   %%%%%     %
% %%%%% %%%%% % %%% %%%%%%%%% %%% % %%% %%%%% %%% % %%% % %%%%%%%%% %%% %%% %%%%%%% %%%%%%%%%%%%%%% %
% %%%       % %             %     % %%% %%%%%     %   % % %   %%%   %%% %%%     %%%   %%%%%%%       %
% %%%%%%%%%%% %%%%%%%%%%%%% % %%%%% %%%%%%%%%%% %%% %%% % % % %%% %%%%% %%%%%%% %%%%% %%%%%%%%% %%% %
%     %%%%%%% %%%%%%%   %%%   %%%%% %%%%% %%%   %%% %%%   % %   % %%%%%     %%% %%% % %%%%%%%%%   % %
%%% % %%%%%%% %%%%%%%%% %%% %%%%%%% %%%%% %%% % %%%%%%% %%%%%%% % %%%%%%% %%%%% %%% % %%%%%%%%%%% %%%
%%% % %%%%%   %   %%%   %%% %%%%%   % %%%     %   %%%   %%%%%%%   %%%     %%%       % %%%%%%%%%   %%%
%%%%% %%%%%%% %%% %%% %%%%% %%%%% %%% %%%%% % %%%%%%% %%%%%%%%% %%%%%%% %%%%%%% %%% % %%%%%%%%% %%%%%
%%%%%     %%% %%% %%%       %%%%%   %   %%% % %%%%%   %%%   %%% %%%%%%%     %%%   %       %%%   %%% %
%%%%% % %%%%% %%% %%% %%%%%%%%%%%%% % %%%%%%% %%%%% %%%%% %%%%% %%%%%%% %%% %%%%% %%%%%%% %%% % %%% %
%%%%% %           %%%       %%%%%%%   %%%%%%%         %%%         %%%   %%%   %%% %%%%%%%     %     %
%%%%%%%%%%%%%%%%%%%%%%%%%%%%%%%%%%%%%%%%%%%%%%%%%%%%%%%%%%%%%%%%%%%%%%%%%%%%%%%%%%%%%%%%%%%%%%%%%%%%%
