%%%%%%%%%%%%%%%%%%%%%%%%%%%%%%%%%%%%%%%%%%%%%%%%%%%%%%%%%%%%%%%%%%%%%%%%%%%%%%%%%%%%%%%%%%%%%%%%%%%%%
%   %%%           % %%%%%   %%%       %%%%%%%%%   %%%       %%%%%%%%%%%%%%%%%%%       % %%% %%%     %
%%% %%% %%%%% %%% % %%%%%%% %%%%%%% %%%%%%%%%%%%% %%%%% %%% %%%%%%%%%%%%%%%%%%% %%% % % %%% %%% %%% %
%%%   % %%%%%   %   %             %   %%%%%   %%% %%%   % % %%%%%%%%%%%%%%%%%%%   % % %   %       % %
%%%%% % %%%%%%% %%% % %%%%%%% %%% %%% %%%%%%% %%% %%% %%% % %%%%%%%%%%%%%%%%%%% %%% % % % %%%%%%%%% %
%%%%% %       % %%% % %       %%%     % %%%%%         %%%   %%%%%%%%%%%%%%%%%%% %%% %   %     %   % %
%%%%% %%%%%%% % %%% % %%% %%%%%%%%%%% % %%%%%%%%%%% % %%% %%%%%%%%%%%%%%%%%%%%%%%%% % %%%%%%% % % % %
%%%     %%%%% % %%%   %%%   %%%%%%%         %%%%%%% %   % %%%%%%%%%%%%%%%     %%%   % %%%       %   %
%%% % %%%%%%% % %%%%%%%%% %%%%%%%%% %%%%%%% %%%%%%%%%%% %%%%%%%%%%%%%%%%%%%%% %%% %%% %%%%% %%%%%%% %
%   %       % %     %%%   %%% %%%   %%%%%   %%%   %%%%%       %%%%% %%% %         %   %%%%% %%%%%   %
% %%% %%%%% % %%%%% %%%%%%%%% %%%%% %%%%%%%%%%% % %%%%%%% %%%%%%%%% %%% % %%% %%% %%%%%%%%%%%%%%% %%%
% %%%   %%%       %         %   %%%     %%%%%   % % %     %%%%%%%       %S%%% %%% %%%%%%%%%%%%%%% %%%
%%%%%%% %%%%%%%%%%% %%%%%%% % %%%%% %%%%%%%%% % % % % % % %%%%%%%%% %%% %%%%% %%%%%%%%%%%%%%%%%%%%%%%
%%%%% %   %%%     %   %%%%% %       %%%%% %%% % % %   % %   %   %%%   %   %%% %%%%%       %%%%% %%%%%
%%%%% % %%%%% %%% %%%%%%%%% % %%% %%%%%%% %%%%% % % %%% %%% %%% %%%%% % %%%%% %%%%% %%%%%%%%%%% %%%%%
%   %   %%%   %%%   %%%%%   % %%% %%%%%   %%%   % % %   %   %   %%%%% % %%%   %%%     %%%%%%%     %%%
% %%% %%%%%%% %%%%% %%%%%%% %%%%%%%%%%% %%%%% %%% %%% % %%% % %%%%%%% %%%%%%% %%%%%%% %%%%%%%%% % %%%
%   %     %%% %   %     %%%     %%% %%%       %%% %%% % %%%   %%%       %%%%%         %%%   %%% %   %
%%% %%%%% %%% %%% %%% %%%%%%%%% %%% %%%%%%%%% %%% %%% %%%%% %%%%%%%%%%% %%%%%%%%%%%%% %%%%% %%% %%% %
%%%   %%%   %   %     %%% %%%%%     % %%%     %%% %   %%%   %%%%%%%%%%%   %%% %%% %%% % %%%     %%% %
%%% %%%%%%% %%% % %%% %%% %%%%% %%% % %%% %%%%%%% % %%%%% %%%%%%%%%%%%%%% %%% %%% %%% % %%% % %%%%%%%
%%%     %%%   % % %%% %%%       %%%       % %%% % % %%%   %%%%%%%   %%%%% %       %   %     %       %
%%%%% %%%%%%% % %%%%% %%%%% % %%%%%%%%%%%%% %%% % % %%% %%%%%%%%%%% %%%%% % %%% % % %%%%% %%% %%%%% %
% %%%         %   %   %     % %%%   %%%           % % % %   %%%         %   %%% % % %%%%% %%% %%%%% %
% %%%%% %%%%%%%%% %%% % %%%%%%%%% %%%%% %%%%%%%%%%% % % %%% %%% %%% %%% % %%%%% % % %%%%% %%%%%%%%% %
% %%%%% %%%%%%%%%   %   %%% %%%   %%%%% %%% %%%     %   %%%   % %%% %%% % %%%%% % % %%%     %%%     %
% %%%%%%%%%%%%%%%%% %%%%%%% %%% %%%%%%% %%% %%% %%%%%%% %%% % % %%%%%%% % %%%%% % % %%%%%%%%%%% % %%%
%     %%%%%     %%% %%%%%%%   %         %%%   % %%%%%%%!    %     %%%%% % %     % %   %%%%%     % %%%
% % % %%%%%%% % %%% %%%%%%%%% % %%% %%% %%% % % %%%%%%%%% %%%%%%% %%%%%%% % %%%%%%%%% %%%%% %%%%% %%%
% % %   % %%% % % %   %%% %%% % %%% %%%     %   %     %%% %%%%%%%   %%%%% %           %     %%%     %
%%% %%% % %%% % % % % %%% %%% % %%%%%%%%% %%%%%%%%%%% %%% %%%%%%% %%%%%%% %%%%%%%%%%%%%%% %%%%%%% %%%
%   %%%       % %   %   % %     %%%%%%%%% %%%%%%%     %%% %%%     %%%%%%% %%%%% %%%%%%%%% %%% %%% %%%
% %%%%%%%%%%%%% %%%%%%% % % %%%%%%%%%%%%%%%%%%%%% %%%%%%% %%% %%%%%%%%%%% %%%%% %%%%%%%%% %%% %%%%%%%
%       %           %   %   %%%%%   %%% %%%         %%% % %%%   %%%%%%% %     %                 %%%%%
% %%%%% %%% %%%%%%% % %%% %%%%%%%%% %%% %%%%% %%%%% %%% % %%%%%%%%%%%%% %%%%% %%%%%%% %%%%% %%% %%%%%
% %%%%% %%% %%%%%     %   %%%   %%%       %%%   %%%       % %%%%%   %     %   %%%%%%%   %%% %%%   %%%
%%%%%%% %%% %%%%% %%%%%%%%%%%%% %%%%% %%% %%%%%%%%% %%% %%% %%%%% % %%%%% % %%%%%%%%%%% %%%%%%% % %%%
%%%       % %%%%% %%%%%   %%%         %%%   %%%%%%% %%% %   %%%%% %       % % %%%   %%%   %%%   %   %
%%%%%%%%% %%%%%%% %%%%% % %%% %%%%%%% %%%%%%%%%%%%%%%%% %%% %%%%% %%%%% %%% % %%% % %%%%%%%%%%% %%%%%
%%%%%%%%%     %     %   %     %%%%%%% %%%%%%%   %%%%%   %%% %%%%%     % %%% % %%% %   %%%%%%%%% %%%%%
%%%%%%%%% %%% %%%%%%% %%%%%%% %%%%%%% %%%%%%% %%%%%%% %%%%% %%%%% %%% %%%%% % %%% %%% %%%%%%%%% %%%%%
%%%   %%%   % %%%       %%%       %%% %%%     %%%%%     %%%   %%%   %   %%% %   % %   %   %%%%%     %
%%%%% %%% %%% %%% %%%%% %%% %%%%% %%%%%%%%% % %%%%% %%%%%%% % %%% %%% % %%% % % % % %%%%% %%%%%%% %%%
% %%%   % %%%     %%%%% %%% %%%   %%%%% %%% %         %%%   %   % %%% %   %   %   %     %   %%%   %%%
% %%% % % %%%%%%%%%%%%%%%%% %%%%% %%%%% %%% %%%%%%% %%%%% %%%%% %%%%%%%%% %%%%%%%%%%%%% % %%%%% %%%%%
%     %         %%%%% %%%     %%%       %%%   %%%%% %%%   %%%       %%%   %   %%% %       %%%%% %%%%%
% %%%%%%%%%%%%% %%%%% %%% % %%%%%%%%%%%%%%%%% %%%%% %%%%% %%%%%%%%% %%% % %%% %%% % %%%%% %%%%% %%%%%
% %%%%%%%   %%% % %%%     %           %%%%%%% %%%%%         %%%     %%% % %   %%%     %%% %     %%%%%
% %%%%%%% %%%%% % %%% %%%%%%%%%%%%%%% %%%%%%% %%%%%%%%%%% %%%%%%% %%%%% % % % %%%%% %%%%% % %%% %%%%%
% %%% %%% %%%%% % %%%   %%%   % %%%   %%% %%% %%%%%       %%%%%%% %%%%% %   %   %%% %%%   % %   % %%%
%%%%% %%% %%%%% % %%%%%%%%% % % %%% %%%%% %%% %%%%% %%% %%%%%%%%% %%%%% %%% %%%%%%%%%%%%% %%% % % %%%
%%%       %     %   %%%%%   %   %   %%%%%   %   %%% %%%       %%%   %   %%% %%%%%%%%%%%%%     % %   %
%%%%% %%%%% %%%%%%% %%%%% % %%% % % %%%%% % %%%%%%%%%%% %%%%% %%%%% % %%%%% %%%%%%%%%%%%%%%%%%% % % %
% %%% %%%%% %   %%%       % %%% % % %%%   %   %%%%%%%%% %%%   %%%     %%%           %%% %%% %%% % % %
% %%% %%%%% %%% %%% %%%%% % %%%%% %%%%% %%%%% %%%%%%%%%%%%%%%%%%%%%%% %%%%%%% %%%%% %%% %%% %%% %%% %
%   %       %   %%%     % % %%%%% %%%%% %%% %       %     %%%%%     % %%%%%%% %%%   %%%     %%%     %
% % % %%% %%% %%%%%%%%%%% % %%%%% %%%%% %%% % %%% %%% %%% %%%%% %%% %%%%%%%%% %%% %%%%% %%%%%%%%%%% %
% % % %%% %%% %%%%%%%%%   % %   % %%%   %   % %   %   %%%     % %%%     %%%   %%%       %%%%%   %   %
% % % %%% %%% %%%%%%%%% %%% % % % %%%%% % %%% %%%%% %%%%% % %%% %%%%% %%%%%%%%%%%%% %%% %%%%% %%% %%%
% %   %%%       %%%     %%%   % %   %%%   %%%       %%%   % %   %   % %%% %%%%% %%% %%% %%%   %   %%%
% %%%%%%%%%%%%% %%%%% %%%%%%%%% %%% %%%%% %%%%%%%%% %%%%% %%% %%%%% % %%% %%%%% %%%%%%%%%%%%% % %%%%%
% %%%%% %%%%%%%       %%%%%%%     %   %   %%%   %%% %%%%% %%% % %%% %           % %%% %%% %%%     % %
% %%%%% %%%%%%% %%%%% %%%%%%%%%%%%% %%% %%%%% %%%%%%%%%%% %%% % %%% %%%%%%% %%% % %%% %%% %%% %%% % %
% %     %%%%%   %%%%%     % %%%%%%%   % %   % %%% %%%   %   %   %   %%%%% %   %   %%%         %%%   %
% %%%%% %%%%%%%%%%%%%%%%% % %%%%%%%%% % % % % %%% %%% % %%% %%% % % %%%%% %%% %%% %%%%%%% %%%%%%%%% %
%       %%% %%%%%                 %%% %   % %       % %   % %%% % %   %%% %%%   % %%%%%%% %%%%% %%% %
%%%%%%% %%% %%%%% %%% %%%%% %%% %%%%% %%%%% %%%%% % %%%%% % %%% %%% %%%%% %%%%% %%%%%%%%%%%%%%% %%% %
%%%   % %%% %%%%% %%%   %%% %%% %%%   %%% %       %       % %   %%%       %%%%%   %%%   %%%       % %
%%% % % %%% %%%%% %%%%% %%%%%%%%%%% % %%% %%%%%%% %%%%% %%% % %%%%% %%% % %%%%%%% %%% % %%%%%%% % % %
%   %       %%%%% %%%   %%%%%%%%%   %     % %%%   %%%%% %%% % %%%   %%% %     %   %%% %   %%%%% % % %
% %%%%%%%%%%%%%%%%%%%%%%%%%%%%%%%%% %%%%% % %%%%% %%%%% %%% % %%%%% %%% %%%%%%% %%%%% % %%%%%%% %%% %
%     %%%%%%%%%%%%% %%%%%   %%%%%%% %   %     %%% %%%   %%%   %%%%% %%%   %%%%%       % %%%     %   %
%%% %%%%%%%%%%%%%%% %%%%% %%%%%%%%% % % %%%%% %%%%%%% %%%%%%%%%%%%%%%%%%% %%%%%%%%%%% %%%%% %%% % %%%
%%% %%% %%% %%%%%%% %%%%% %%% %%% %   %   % %   %%%   %     %%%%% %%% %%% %%%%%     %       %%% %   %
%%%%%%% %%% %%%%%%% %%%%% %%% %%% % %%%%% % % %%%%%%% %%% % %%%%% %%% %%% %%%%%%%%% %%%%%%%%%%% % %%%
% %%%         %%%         %   %   %   %%% %   %%% %%% %%% %       %   %%%   %%%%%   %%%%%%%%%%% % %%%
% %%% %%%%% %%%%% %%%%% %%% % % % %%% %%% %%% %%% %%% %%%%%%% %%% % % %%% %%%%%%% % %%%%%%%%%%% % %%%
% %     %%%     %     %     %   %   % %%%   %       %       % %%% % % %   %%%     % %%%         % %%%
% % %%%%%%%%% %%%%%%% %%%%%%%%%%% %%% %%%%% %%%%% %%%%%%%%% %%%%% % % % % %%%%%%% %%%%%%%%% %%% % %%%
%   %%%%%%%%%     %%% % %%%   %   %%%     %     % %%%     %   %%%   %   %       %     %%%%%   % % % %
% %%%%%%%%%%%%% %%%%% % %%%%% % %%%%%%% %%%%%%% % %%% % %%%%% %%%%% %%%%% %%%%% %%%%% %%%%%%% %%% % %
% %%%   %%% %%% %%%           %         %%%%%%% %     % %%%%% %%%%%     %   %%%         %   % %%%   %
% %%% % %%% %%% %%%%%%%%%%% %%% %%%%% %%%%%%%%% %%%%%%%%%%%%% %%%%%%% %%%%% %%%%% %%%%% % %%% %%%%% %
%   % % %   %     %%%   %%% %%% %%%%%   %%%     %         %%% %%% %%% %%%%% %%%   %%%   % %%% %%%   %
% %%% % % % % % % %%% %%%%% %%%%%%%%%%% %%%%% % % %%% %%% %%% %%% %%%%%%%%% %%%%%%%%%%% % %%% %%% %%%
% %%% % % %   % %     %%%   % %%%     %   %%% % % %%% %%% %%%       %%%     %%%%%%%%%%%     %   %   %
% %%% % %%%%%%% %%%%%%%%% %%% %%%%% %%% %%%%% %%% %%%%%%% %%%%%%%%% %%%%% %%%%%%%%%%%%% %%%%% %%%%% %
% %%% %   %%%   %%%%%%%%% %%% %%%%%     %%%%%       %%%     %%%   % %     %%%   %%%%%%% %%%%%   %   %
%%%%% %%% %%% % %%%%%%%%% %%% %%%%%%%%% %%%%%%% %%% %%%%% %%%%% % % % %%% %%% % %%%%%%% %%%%%%% % %%%
%%%   %%%     % % %           %   %%%%%     %%% %%% %%%%% %%%   % %   %%% %%% %   %%%   %%%%%%%   %%%
%%% % %%% %%%%% % % %%%%%%%%% % % %%%%% %%%%%%% %%%%%%%%% %%% % % %%%%%%%%%%%%% % %%% %%%%%%%%%%%%%%%
%%% %   % %%%%%   % % %%%%%%%   %   %%% %%%%%     %%%%% %     % % %%%%% %%% %%% % %%% %   %%%       %
%%%%%%% %%%%%%%%% % % %%%%%%%%%%%%% %%%%%%%%%%% %%%%%%% %%%%% % %%%%%%% %%% %%% % %%% % % %%%%% % %%%
%%%     %%%       %   %%%%% %%%%%   %%%%%%% %%% %%%     %%%%% %   %%% %         % %   % %     % %   %
%%% %%% %%% %%%%% % %%%%%%% %%%%% %%%%%%%%% %%%%%%% %%%%%%%%% %%% %%% % %%%%%%% %%% %%% % %%% % %%% %
% %   % %%% %%%%% % %%%%%     %%% %         %%%%%   %%%%%%%%% %%% %     %   %%%     %%% % %   % % % %
% % % %%%%% %%%%%%% %%%%% %%%%%%% % % %%%%% %%%%% % %%%%%%%%% %%% % %%%%% %%%%% %%% %%%%% % %%% % % %
%   %   %   %%%       %%%   %%% % % %   % %       % % %%%%%%% %%%         %%%%% %%% %%%   % %%%   % %
% %%%%% %%%%%%% %%%%% %%% % %%% % %%%%% % % %%% %%% % %%%%%%% %%% %%% %%% %%%%%%%%% %%% %%% %%%%%%% %
%   %%%         %%%%% %%% %             %   %%% %%%     %%%   %%% %%% %%%     %%%%%     %           %
%%%%%%%%%%%%%%%%%%%%%%%%%%%%%%%%%%%%%%%%%%%%%%%%%%%%%%%%%%%%%%%%%%%%%%%%%%%%%%%%%%%%%%%%%%%%%%%%%%%%%
