%%%%%%%%%%%%%%%%%%%%%%%%%%%%%%%%%%%%%%%%%%%%%%%%%%%%%%%%%%%%%%%%%%%%%%%%%%%%%%%%%%%%%%%%%%%%%%%%%%%%%
%     %%%       %%%%%%%         %%%         %%%   %%%         % %       %%%%%%%%%     %%%           %
%%% % %%% %%%%% %%%%%%% %%%%% % %%%%% % %%%%%%% %%%%% %%% %%% % % %%% %%%%%%%%%%%%% %%%%%%% %%%%%%% %
%   % %%%   % %   %%%   %%% % % % %%% % %%%       %%% %%% %%%   %   %       %%% %%%     %   %%%%%%% %
% %%% %%%%% % % %%%%%%% %%% % % % %%% %%%%% %%% % %%% %%% %%%%%%%%% %%% %%% %%% %%% %%% % %%%%%%%%%%%
% %     %%% % %   %%%%%     % %       %%%   %%% %     %%%   %   %   %%% %%% %%%       %S%       %%%%%
% %%%%%%%%% % %%% %%%%%%%%% % %%%%%%%%%%%%% %%%%%%%%%%%%% %%% % % %%%%% %%%%%%% %%%%%%%%%%% % %%%%%%%
%     %%%       % %%% %%%%% % %       %%%%% %%%%%       %   % %   %   %         %%% %%%%%%% %   %%% %
%%% % %%% %%%%%%% %%% %%%%%%% % %%%%% %%%%% %%%%% % %%%%%%% % %%%%% %%%%% %%%%%%%%% %%%%%%%%%%% %%% %
%%% %     %%%%%%% %%%     %%%     %%%   %%%   %%% %       %   %%%   %%%%%   %%%     %     %%%       %
%%%%%%% %%%%%%%%% %%%%% % %%% %%%%%%%%% %%% %%%%%%% %%% %%%%%%%%%%% %%%%%%%%%%%%% % % %%%%%%% % %%% %
%%%%%%% %%% %%%%% %%%%% % %%% %%%%% %%%     %%%%%%% %%%   %%%%%         %%%%%     %   %%%%%   % %%% %
%%%%%%%%%%% %%%%% %%%%% %%%%%%%%%%% %%% %%%%%%%%%%%%%%%%% %%%%% %%%%%%%%%%%%% %%% %%%%%%%%% % %%%%% %
%     %%%     %%%       %%%%%%% %   %%% % %%%     %%%%%%%       %     %       %%% %%%%%     % %%%   %
% %%% %%%%% % %%%%%%% % %%%%%%% % % %%% % %%%%% %%%%%%%%% %%%%% % %%% % %%%%% %%%%%%%%% % %%% %%%%% %
% %%% %%%   % %%%     %         % %   %   %     %%%%%%% % %%%%% % %%%   %   % %%%%%   % % %%%   %%% %
% %%% %%% %%%%%%% %%% %%%%%%% %%% %%% %%% % %%% %%%%%%% % %%%%% % %%% %%% %%% %%%%% % %%% %%%%%%%%%%%
% %%%     %%%%%     % %   %   %%% %%%     % %%%       % %   %%%   %%% %   %%%   %   % %%%       %%%%%
%%%%% %%%%%%%%%%%%% % % % %%% %%% %%%%%%%%% %%%%%%%%% % %%% %%%%% %%% % %%%%% % % %%% %%%%% %%% %%%%%
%%%   %%%%%%%%%%%   % % %   % %%% %%%       % %%%%%%% %     %%%%% %%%   %%%   %   %%% % %%% %%%   %%%
%%% % %%%%%%%%%%% %%%%% %%% % %%% %%% % %%%%% %%%%%%% %%% %%%%%%% %%% %%%%%%% %%% %%% % %%%%%%% % %%%
%   % %%%%%%%%% %       %%% % %%% %%% % %%%%% %%%       %     %%% %%% %%%     %   %%%   %%%%%   % %%%
% % %%%%%%%%%%% % %%%%%%%%% %%%%% %%%%% %%%%% %%%%%%%%% %%% %%%%% %%%%%%% %%% %%%%%%%%% %%%%% %%%%%%%
% %       %%%%%   %%%     %       %     %%%%% %%%%%%%   %%% %%%   %       %%% %%%%%%%%% %%%   %%%%%%%
% %%%%% % %%%%%%% %%% %%% %%%%%%%%% % %%%%%%% %%%%%%% %%%%%%%%% %%% %%% %%%%% %%%%%%%%% %%% % %%%%%%%
% % %%% % %%% %%%     %%% %%%     % % %%%         % % %   %%%%% %%%   % %%%%% %   %%% % %%% %     % %
% % %%%%% %%% %%%%%%%%%%% %%% % % % %%%%% %%%%%%% % % % %%%%%%%%%%% % %%%%%%% % %%%%% % %%%%% %%% % %
%     %   %     %         %   % %   %%%   %%%%%%%   % %   %%%%%%%   %     %%%   %%%%%   %     % %   %
%%% %%% % %%%%% % %%%%%%%%% %%% %%%%%%% %%%%%%%%% %%% %%% %%%%%%%%% %%%%% %%%%% %%%%% %%%%% %%% % %%%
%   %%% %       % %%% %%%%%   % %%%%%   %%%       %%% %     %   %%% %%%%%   %%% %%%%%     %   %   %%%
% %%%%% %%%%%%% % %%% %%%%%%%%% %%%%%%% %%%%% %%%%%%% % %%% % % %%% %%%%% % %%%%%%%%%%%%% %%% % %%%%%
% %%% %     %   % %%%     %     %%%       %%%   %       %%%   % %%% %%%   % %%%%%%%     % %   % %%%%%
% %%% %%%%% %%%%% %%% %%% % %%%%%%%%% %%% %%%%%%% %%%%%%%%%%%%% %%%%%%%%% %%%%%%%%% %%%%% % % %%%%%%%
% %%%     % %%%%%     % %   %%%%%%%%% %%%   %%%%%   %%%%%%%%% % %%%%%%%%% %%% %%%   %     % % %%%   %
% %%% %%% % %%%%%%%%%%% %%%%%%%%%%%%% %%%%%%%%%%%%% %%%%%%%%% % %%%%%%%%% %%% %%%%% % %%%%% %%%%%%% %
%     %%% % %%%   %%%     %%%%% %%%           %%% % % %%%%%%%     %%%%%         %%%     %%%     %%% %
%%%%% %%%%% %%% %%%%% %%%%%%%%% %%% %%% %%%%% %%% % % %%%%%%%%%%% %%%%%%%%% %%% %%% %%%%%%%%%%% %%% %
%%%%% %%%%%     %%%   %%%%%       % %%% %%%   %%%     %%%%%%%%%%% %%%     % %%% %%%   %%%%%%%     % %
%%%%%%%%%%% %%% %%%%% %%%%% %%% %%% %%%%%%% %%%%%%%%% %%%%%%%%%%%%%%% %%% %%%%% %%%%% %%%%%%% %%% % %
%   %%%     %   %%%%%       %   %     %%%   %%% %%%   %   %%%%% %%%   %         %         %   %   % %
% % %%%%%%% %%% %%%%%%%%% %%% %%% %%%%%%% % %%% %%% %%%%% %%%%% %%%%% % %%%%%%% %%% %%%%% %%% %%% % %
% %   %%%   %%%   % %%%%% %%% %   %%%%% % % %       %%%%% %%%         % %%%     %%% %%%%%     %%%   %
% %%% %%% % %%%%% % %%%%% %%% % %%%%%%% % %%% %%%%%%%%%%% %%% %%%%%%%%%%%%%%%%%%%%% %%%%%%%%%%%%% %%%
% %%%     %   %%%   %%%   %%% % % %%%   %     %%%   %%%%% %     %%%%%%%%%%%%%%%%%%%     %%% %%%   %%%
% %%%%%%%%% %%%%%%% %%% % %%%%% % %%%%% %%%%%%%%% %%%%%%% % %%% %%%%%%%%%%%%%%%%%%%%%%%%%%% %%% %%%%%
% %%%%%%%%% %%% %%% %%% %     % %   %     %%%     %%%   %     %       %%%%%%%%%%%%%%%%%%%       %%%%%
% %%%%%%%%%%%%% %%% %%%%% %%% % % % % % %%%%% %%% %%%%% % %%% %%% %%% %%%%%%%%%%%%%%%%%%% %%% %%%%%%%
%   %%%%%%%%%         %%% %%%     % % % %%%   %%%   %%%   %%% %%% %   %%%%%%%%%%%%%%%%% % %%%     %%%
% % %%%%%%%%%%% %%%%%%%%%%%%%%% %%% % % %%% % %%%%% %%%%%%%%% %%% %%% %%%%%%%%%%%%%%%%% % %%%%% %%%%%
% % %%%%%   %%%   %%%%% %%%%%%% %%% % % %   %   %%% % %%%%%%%   %   %   %%%%%%%%%%%%%%%     %%% %%%%%
% % %%%%% %%%%% %%%%%%% %%%%%%%%%%% % % % %%%%%%%%% % %%%%%%%%%%%%% %%%%%%%%%%%%%%%%%%% %%% %%%%%%%%%
% % %%%   %%%   %%%%%%% %%%%%%%%% % % % % %%%%%%%   %   %%%         %%%%%%%%%%%%%%%%%   %%%   %%% %%%
%%% %%% % %%%%%%%%%%%%% %%%%%%%%% % % % % %%%%%%% %%% %%%%% %%%%%%%%%%%%%%%%%%%%%%%%% %%%%%%%%%%% %%%
%%%     %   %%%%%%%%%   %%%   %%% %   %   %%%     %   %%%       %%%%% %%%%%%%%%%% %%% %%%%%%%%%   %%%
%%% %%%%% %%%%%%%%%%% %%%%% %%%%% %%% %%% %%%%%%% % %%%%% %%%%% %%%%% %%%%%%%%%%% %%% %%%%%%%%% % %%%
%   %     %%%   % %%% %%%   %%%   %%% %%%   %%%%%   %%%   %%% % %         %%%   % %%% % %%%%%%% %   %
% %%% %%%%%%% % % %%% %%% %%%%% %%%%% %%%%%%%%%%% %%%%%%% %%% % % %%%%%%% %%% % % %%% % %%%%%%%%% % %
% %%% %       %           %%%   %%% % % %%%%%     %%% %%%     %   %%%%%   %   %   %%% %   %%%     % %
%%%%% % % %%%%%%%%% %%%%%%%%%%% %%% % % %%%%%%% %%%%% %%%%%%% %%%%%%%%% %%% %%%%% %%% %%% %%% %%%%% %
%%%     % %%%       %%%%%%% %%%     % %     %%%   %%%     %%%         % %   %%%%% %%%   %         % %
%%% %%%%% %%%%% %%%%%%%%%%% %%%%%%% % %%%%% %%%%%%%%% %%% %%%%%%% %%%%% % %%%%%%% %%%%% %%%%% %%% %%%
%%% %%%%% %   % %           %%%%%   %         %%%%%   % % % %     %%%%% % %%%%%%%   %   %%%%%   % %%%
%%% %%%%% % % % % % %%%%%%% %%%%% %%%%%%%%% %%%%%%% %%% % % % %%%%%%%%% % %%%%%%%%%%% %%%%%%%%% % %%%
%%% %%%%%   % % % % %%%%%%%   %%% %%%     % %%%%%%% %     % % %%%%%     %   %%%   %     %%%%%%% %   %
%%%%%%%%% %%% % % %%%%%%%%%%%%%%% %%% %%% % %%%%%%% %%% %%% % %%%%% %%% %%% %%% % % %%%%%%%%%%%%%%% %
% %%%     %%% %   %%%     %%%%%     %   %   % %%%   %%%     % %%%%% %   %%% %   %   %%%%%     %%%   %
% %%% %%%%%%% %%%%%%%%% % %%%%% % % %%% %%%%% %%% %%%%% %%% % %%%%% %%%%%%% % %%%%%%%%%%%%% %%%%% %%%
%     %%%   %           % %%%   % % %%%     %     %%%%% %%% %   %   %%%%%   %   %%%     %%% %%%   %%%
% %%% %%% % % %%%%%%% %%%%%%%%%%% %%%%%%%%% %%%%% %%%%%%%%%%%%% % %%%%%%% %%%%% %%% %%%%%%% %%% %%%%%
% %%%   % % %     %%%   %%%   %%% %%%%%%%%% %%%%%               %   % %%%       %%% %%%%%   %   %%%%%
% %%%%% % % % %%%%%%%%% %%% % %%% %%%%%%%%% %%%%%%%%% %%%%% %%%%%%% % %%% %%%%%%%%% %%%%% % % %%%%%%%
% %%%   % % % %%%           % %         % %     %%%%% %%%%% %%%     %   % %   %%%         %   %%%%% %
%%%%%%%%% % %%%%% %%%%% %%%%% % %%%%%%% % %%%%% %%%%%%%%%%%%%%% %%%%% % % %%% %%%%%%% %%%%%%%%%%%%% %
%%%       %       %%%%% %%%     %%%   %     %   %%% %%%   %%%   %     % % %%%   %%%%% %%%%%%%       %
%%% %%%%%%% %%%%% %%%%%%%%% %%%%%%%%% % %%%%% %%%%% %%% %%%%% % % %%%%% % %%%%% %%%%% %%%%%%% %%%%% %
% %   %%% % %%%%% %%% %%%   %%%%% %%%   %%%%%           %%%%% % %     % % %%%%%           %%%     % %
% % % %%% % %%%%%%%%% %%%%% %%%%% %%% %%%%%%%%%%%%%%% %%%%%%%%% % %%% %%% %%%%%%%%% %%%%%%%%% %%% % %
%   % %       %%%%%   %%%%% %%%   %%%   %   %%%%%%%   %%%%%%%   %   %     %%%       %%%%%%%   %%% % %
%%%%% %%% %%% %%%%% %%%%%%% %%%%% %%% %%% % %%%%%%% %%%%%%%%% %%%%% %%%%%%%%%%% %%% %%%%%%% %%%%%%% %
%%%   %%% %%% %%%%%       % % %%%   % %%% %       % %%%   %   %%%   %%% %%%%%%%   %     %%%   %     %
%%% %%%%%%%%%%%%%%%%% %%% % % %%%%% % %%% %%%%% % % %%% % %%% %%% %%%%% %%%%%%%%% %%%%%%%%% %%% %%% %
%   %%%%%%%%%%%%%%%%%   % % % %%%%%     % % %%% %   %   % %   %%%   %%%       %%%   %%%%% % %%% %   %
% %%%%%%%%%%%%%%%%%%% %%% % % %%%%%%%%% % % %%%%%%% %%% % % %%%%% %%%%%%% %%% %%%%% %%%%% % %%% %%%%%
%     %%%     %%% %%% %%%       %     % %   % %%%%%     %   % %%% %%%     %%% %%%%%       % %%%     %
% %%% %%%%% %%%%% %%%%%%% %%%%%%% %%% %%%%% % %%%%%%% %%%%%%% %%% %%% %%%%%%% %%%%%%% %%%%% %%%%%%% %
% %%%       %%%     %%% %   %     %%% %%%         %%% %%%       %     %     %   %%%%%         %%%%% %
%%%%%%% %%%%%%% %%%%%%% % %%% %%%%%%% %%% %%% %%%%%%%%%%% %%% %%%%%%%%% % % % %%%%%%%%% %%%%%%%%%%% %
%%%%%%%   %     %%%%%     %   % %%%%%    !%%% %%%%%%%%%   %%% %%% %%%   % % % %%%   %%%     %%% %   %
%%%%%%% % % % %%%%%%%%%%% % %%% %%%%%%%%%%%%%%%%%%%%%%% %%%%%%%%% %%% %%% %%% %%% % %%%%%%% %%% % % %
%%%%%   %   %       %%%%% % %   %%%%%%%%%%%%%%%%%%%%%%%             %   % %   %%% %       % %%%   % %
%%%%% %%%%%%%%%%%%% %%%%%%% %%% %%%%%%%%%%%%%%%%%%%%%%%%% %%%%%%% % %%%%% % %%%%%%% %%%%% % %%%%% % %
%%%%%       %%%       % %   %%% %%%%%%%%%%%%%%%%%%%%%%%%%   % %%% %       % %%% %%% %%% % %   %%% % %
%%%%% %%% %%%%% %%%%% % % %%%%% %%%%%%%%%%%%%%%%%%%%%%%%%%% % %%% %%%%%%%%% %%% %%% %%% % % %%%%%%% %
%%%   %%% %%%   %%%     % %%%       %%%%%%%%%%%%%%%%%%%%%%%   %%%   %%%         %     % % % %%%     %
%%% %%%%%%%%% %%%%% %%% % %%%%%%% % %%%%%%%%%%%%%%%%%%%%%%%%% %%%%% %%% %%%%%%% %%%%% % % %%%%% %%% %
% % %   %%% %   %%% %%% % %     % %     %%%%%%%%%%%%%%%%%%%%%   %%%       %%%%%       %   %%%%% %   %
% % % %%%%% %%% %%%%%%%%% % %%% % %%% %%%%%%%%%%%%%%%%%%%%%%% %%%%%%%%%%% %%%%% %%%%%%% %%%%%%% %%% %
%     %%%   %%% %           %%%   %%% %%%%%%%%%%%%%%%%%%%%% % %%% %%%%%%%   %%% %%%%%           %%% %
%%%%% %%%%% %%% % %%%%% %%%%%%%%%%%%% %%%%%%%%%%%%%%%%%%%%% % %%% %%%%%%% %%%%% %%%%% %%%%%%%%% %%%%%
%%%%%       %%%     %%%   %%%%%%%     %%%%%%%%%%%%%%%%%%%%%         %%%   %%%%% %%%%%   %%%%%   %%%%%
%%%%%%%%%%%%%%%%%%%%%%%%%%%%%%%%%%%%%%%%%%%%%%%%%%%%%%%%%%%%%%%%%%%%%%%%%%%%%%%%%%%%%%%%%%%%%%%%%%%%%
