%%%%%%%%%%%%%%%%%%%%%%%%%%%%%%%%%%%%%%%%%%%%%%%%%%%%%%%%%%%%%%%%%%%%%%%%%%%%%%%%%%%%%%%%%%%%%%%%%%%%%
%   %%%   %%%%%%% %%%%%     %%%%%%%       %%%   %%%%%%%   %%%             %%%     %%%%%   %%%     %%%
% %%%%% % %%%%%%% %%%%% % %%%%%%%%%%% % % %%% % %%%%%%% % %%% % %%%%%%%%%%%%% %%% %%%%% %%%%%%% %%%%%
%       % %%%%% %       %  !  %%% %%% % %   % %   %%%   % %%% % %               %     %         %%% %
%%% %%%%% %%%%% % %%%%%%%%% % %%% %%%%% %%% %%% %%%%% %%% %%% % % %%%%%%%%%%%%% %%% %%% %%% %%% %%% %
%%% %%%     %%%   %%%%%%%%% %       %%% %%%     %%%   %%% %%% % % %%%   % %%%%%   % %   %   %   %%% %
%%% %%%%%%%%%%%%%%%%%%%%%%% %%% %%%%%%% %%%%%%% %%%%% %%%%%%%%% % %%% % % %%%%%%% % % %%% %%%%%%%%% %
%   %       %%%%%%%         %   %%%%%   %%%%% % %   %   %%% %%% %     %     %%%   %   % %     %%%   %
%%% % %%%%% %%%%%%%%% %%%%% %%%%%%%%% %%%%%%% % % % % %%%%% %%% %%% %%%%%%% %%%%% %%% % %%%%% %%% %%%
%%%     %%% %%%   %%% %%%%% %         %%%%%   %   %   %%%%%         %%%%%%%   %%% %%%   %   %     %%%
%%%%% %%%%% %%%%% %%% %%%%%%% %%%%%%% %%%%% %%%%%%% %%%%%%% %%% %%%%%%%%%%% %%%%% %%%%% % %%% %%% %%%
% %%% %   %   %%%   %         %   %%%   %%% %   %   %%%%%%% %%% % %%%%%%%%% %%%     %%%   %%% %   %%%
% %%% % % % %%%%% %%% %%%%%%%%%%% %%%%% %%% % % % %%%%%%%%%%%%% % %%%%%%%%%%%%% %%%%%%%%%%%%%%% %%%%%
% %   % %   %%%   %%%     %%%     %%%%% %%% % %   %%%     %%%       %%%%%%%%% % % %%%           %%% %
% % %%% %%% %%% % %%%%%%% %%% %%% %%%%% %%% % %%%%%%% %%% %%%%% %%% %%%%%%%%% % % %%% % %%% %%%%%%% %
%   %   %%% %%% %   %%% %     %   %   %   %   %       %   %%%%% %%% %%%%%%%       %%% % %%% %%%%%%% %
% %%% %%%%%%%%%%% %%%%% %%%%%%% %%% %%%%% % %%% %%%%% %%% %%%%%%%%% %%%%%%%%%%% %%%%% %%%%% %%%%%%% %
% %   %%% %%%     %     %%%%%       %%%%% % %%% %%%%% %%% %%% %%% % %%%%%%%%%%% %%%%%   %           %
%%% % %%% %%% %%%%% %%% %%%%% %%%%%%%%%%% % %%% %%%%% %%%%%%% %%% % %%%%%%%%%%%%%%%%%%% %%% %%%%% %%%
%%% % %%% %           %       %%%%%       % %   %%%   %%%%%   %%%       %     %%%%%%%%% %%% %%%   %%%
%%% % %%% % %%% %%%%% %%%%%%% %%%%% %%% %%% %%% %%%%%%%%%%% %%%%%%%%%%% % % %%%%%%%%%%% %%%%%%%%%%%%%
%   % %   % %%%   %%%   %%%%%   %%% %%% %%%     %%%         %%%%%%% %%% % % %%%%%%%%%     %     %%% %
%%% %%% % % %%% %%%%%%%%%%%%%%% %%% %%% %%%%% %%%%% %%%%% %%%%%%%%% %%% %%% %%%%%%%%%%% % % %%% %%% %
%%% %%% %   %%% %%% %%%%%%%%%%% %%% %   %%%   %     %%%%%         %     %%%   % %%%%%%% %   %%%     %
%%% %%% %%% %%%%%%% %%%%%%%%%%%%%%% %%%%%%%%%%% %%%%%%%%%%%%% %%% %%%%% %%% % % %%%%%%% %%%%%%%%% %%%
% %     %%%   %%%%%     %%%   %%%%%         %     %%%     %%%   % %%%%%     % % %%%%%%% % %%%%%%%   %
% % %%%%%%%%% %%%%% %%% %%% %%%%%%%%%%%%% % % %%%%%%% %%% %%% %%% %%%%%%%%%%% % %%%%%%% % %%%%%%% % %
%     % %%%%%     % %       %%%%%%%%%%%%% %   % %%%   %%% %%% %%%   %%%%%%%   % %%%%%     %%% %%% % %
%%%%% % %%%%%%%%% % % % %%%%%%%%%%%%%%%%%%% %%% %%%%%%%%% %%%%%%% % %%%%%%% %%% %%%%%%% %%%%% %%%%% %
%%%%%     %%%%%%% % % % %%%%%     %     %%%             %   %%%   %   %%%   %   %%%%%%% %%%%% %%%%% %
%%%%%%% %%%%%%%%% %%% % %%%%% %%% % %%% %%%%%%%%%%% %%% % %%%%% %%% %%%%%%% %%% %%%%%%%%%%%%% %%%%% %
%   %%% %%%%%%%%%     % %%%   %%%   %%%   %%%%%     %%% % %%%%% %   %%%%%%%     %%%%%%%%%%%         %
%%% %%%%%%%%%%%%%%%%%%% %%%%% %%%%% %%%%% %%%%%%%%%%%%% % %%%%%%% %%%%%%%%%%%%% %%%%%%%%%%%%% %%% %%%
%%% %%%%% %%%%%%%%%%%   %%%%%   %%%   %%%     %%%%%%%     %%% %%% %%%%% %%%%%%%   %%%     %%% %%%   %
%%% %%%%% %%%%%%%%%%%%%%%%%%% %%%%%%% %%%%% %%%%%%%%% %%%%%%% %%% %%%%% %%%%%%%%% %%% %%% %%%%%%%%% %
%         %%%%%%%%%%%%%%%     %%%%%%% %%%%% %%% %%%   %%%    S%   %%%   %%%%%     %%%   % %%%%% %%% %
% %%%%%%% %%%%%%%%%%%%%%%%%%% %%%%%%% %%%%%%%%% %%% %%%%% %%%%% %%%%% %%%%%%%%%%%%%%%%% %%%%%%% %%% %
% %%%%%   %%%     %%% %%%%%%%   %%%   %   %%%     % %   %   %   %%%   %%%%%%%%%%%%% %%%     %   %%% %
% %%%%%%% %%% %%% %%% %%%%%%% %%%%%%%%% % %%% %%% % % % %%% % %%%%% % %%%%%%%%%%%%% %%%%% % %%% %%% %
% %%% %%% %%% %%% %     %       %%%%%%% %     %   %   % %%%   %%% % %     %%%%%%%%%       % %%% %%% %
% %%% %%% %%% %%% % %%% %%%%%%% %%%%%%% %%% %%% %%%%%%% %%%%% %%% % %%%%% %%%%%%%%%%%%% %%% %%% %%% %
% %           %%%   %   %%%%%   %%% %   %%%   %   %%%%%   %%% %%% % %   % %%%%%   %%%   %%%         %
% %%% %%%%%%% %%% %%% %%%%%%% %%%%% % %%%%%%% %%% %%%%%%% %%% %%% % %%% % %%%%% %%%%% %%%%% %%%%%%%%%
% %%% %%%%%%% %%% %%%         %%%   % %%%%%   %   %%% %%% %%% %%%     % %       %%%   %%%   %%%%%%%%%
% %%%%%%%%%%%%%%% %%% %%%%%%%%%%% %%% %%%%%%% % %%%%% %%% %%%%%%%%%%% % %%%%% %%%%% % %%%%% %%%%%%%%%
% %%%   %%%%%%%%% %%% %%%%%%%%%           %%% %   %%% %%% % %%%   %%%     %%%       % %%%%% %       %
% %%% % %%%%%%%%%%%%%%%%%%%%%%%%% %%%%%%%%%%%%%%% %%% %%% % %%% % %%%%%%%%%%%%% %%% %%%%%%%%% % % %%%
%     %         %%% %         %%% %%%%%%%%%%%%%         %       % % %%%%%       %   %%%       % % %%%
% %%%%%%%%%%% %%%%% % % %%%%% %%% %%%%%%%%%%%%% %%%%%%% %%%%%%%%% % %%%%% %%%%%%%%%%%%% %%%%%%% % %%%
%     % %%%%%         %   %%% %   % %%%     %%%   %       %%%       %%% %     %   %   %   %%%   % % %
% %%% % %%%%%%%%%%%%%%%%% %%% % %%% %%%%% % %%%%% %%%%%%%%%%% %%%%%%%%% % %%% % % % % %%% %%% %%% % %
% %%% %   %%%%%     %     %   %       %%% %   %%%   %%%%%%%%%     %%%     %%%   % % %       % %     %
%%%%% %%% %%%%%%% % % %%%%% %%%%%%%%% %%%%%%% %%% % %%%%%%%%%%% %%%%% %%% %%%%%%% % %%%%% %%% % %%% %
%%%%%   %         % % %%%%% %%%         %     %%% % %%%         %%%   %%% %%%%%%%   %%%%% %%% % %%% %
%%%%%%% %%%%% %%% %%% %%%%% %%% %%%%%%% % %%% %%%%% %%%%% %%%%%%%%% %%%%%%%%%%%%%%% %%%%% %%% %%%%% %
%%% %%% %%%%% %%% %%%   %%%   %   %%%   % %%%   %%%   %%% %%%%%%%%%     %%%     %%% %%%     % %%%%% %
%%% %%% %%%%% %%%%%%%%% %%% %%%%% %%%%% % %%%%% %%%%% %%% %%%%%%%%%%%%%%%%% %%% %%%%%%%%%%%%% %%%%%%%
%         %%%     %%%   %   %%% % %%%%%     %%% %%%     % %   %%%%%         %%%             %     %%%
% %%% %%%%%%% %%% %%% %%%%%%%%% % %%%%%%%%% %%%%%%% %%% % %%% %%%%% % %%% %%%%%%%%%%%%%%%%% % % %%%%%
% %%% % %%%   %   %   %%%%%%%       %%%%%%%   %%%   %%% %     %%%%% % %%% %%%%%%%%%   %%%%%   % %%% %
% %%% % %%%%%%% %%% %%%%%%%%% %%% %%%%%%%%%%%%%%%%% %%%%%%% %%%%%%% %%%%%%%%%%%%%%% %%%%%%%%% %%%%% %
% %%%     %%%%% %%%           %%% %%%%% %%%   %%%%%   %%%%% %%%     %%%%%%% %%%     %%%   %%% %%%   %
% %%%%%%% %%%%% %%%%%%%%%%%%%%%%% %%%%% %%% % %%%%%%% %%%%% %%% %%%%%%%%%%% %%%%%%% %%%%% %%% %%%%% %
% %%%%%%% %%%     %%% %%%   %%% %   %%%     % %%% %%%     %     %%%%%   %%%   %%%           %   %   %
% %%%%%%%%%%% % % %%% %%%%% %%% % %%%%% % %%% %%% %%%%% %%% %%%%%%%%%%% %%%%% %%% %%%%% %%% %%% % %%%
%   %%%%%%%%% % %         % %%%   %%%   % %             %%% %%%                 %   %   %%%   %   %%%
%%% %%%%%%%%%%% %%% %%%%% % %%%%%%%%% %%% %%%%% %%% %%%%%%%%%%% %%% %%% %%%%%%%%% % %%%%%%%%% %%% %%%
%%%   %%%%%%%   %%% %%% %     %%%%%   %%% %%% % %%% %%%%% %%%   %   %%% %%%   %   %   %%%%%%% %%%   %
%%%%% %%%%%%% %%%%% %%% %%% %%%%%%%%% %%% %%% % %%%%%%%%% %%%%%%% %%%%%%%%% % % %%%%% %%%%%%%%%%%%% %
%%%%%   %%%     %   %%%     %%% %%%%% %%% %%%   %   %     %%%%%%%   %     % % % % %%% %%%     %     %
%%%%%%% %%%%%%% % %%%%% %%% %%% %%%%% %%% %%%%%%% % % %%% %%%%%%% % % % %%% % % % %%% %%% %%% % %%% %
%%%%%   %%%%%   % %%%%% %%% %   %%%   % %     %%% %   %%%     %%% %   % %   %     % %   %   %   %%% %
%%%%%%% %%%%% % %%%%%%%%%%% %%% %%%%% % %%%%% %%% %%%%%%%%%%% %%%%%%% % % %%%%%%% % %%% % %%%%%%%%%%%
%%%%%%%       % %%%%%%%%% % %   %%%%%     %%%         %%%%%     %%%%% %     %%%%%     %   %%%     %%%
%%%%%%%%%%%%% %%%%%%%%%%% % % %%%%%%%%%%% %%%%%%%%%%% %%%%% %%%%%%%%%%% %%%%%%%%%%%%% %%%%%%%%% %%%%%
%%%%%%%%%%%%% %%% %%%%%%% %   %%%%% %%%   %   %%%%%       %         %%% %%%%% %%%   %     %     %%%%%
%%%%%%%%%%%%% %%% %%%%%%% %%% %%%%% %%%%% % % %%%%% %%% %%%%%%%%%%% %%%%%%%%% %%% % %%%%% %%% %%%%%%%
%   %%%       %%%   %%%     % %     %%%%%   %   %%% %%% %       %%% %%%%%%%%%   % %   %%% %%%       %
% % %%% %%%%%%%%% % %%%%%%% % % %%% %%%%%%%%%%% %%%%%%%%% %%%%% %%% %%%%%%%%%%% % %%% %%% %%%%% %%%%%
% % %   %         %   %%%%% %   %       %%%%%%% %   %%%%% %%%%%     %%%%%%%%%%%     % %%% %     %%%%%
% %%% %%%%% %%% % %%%%%%%%% %%%%%%%%% %%%%%%%%%%% % %%%%% %%%%%%%%% %%%%%%%%%%% %%%%% %%% % %%% %%%%%
%   % %%%%% %   % %%%%%%%   %%% %%%   %%%%%   %   %       %%%%%     %%%%%%%%%%% %%%%%   % % %%%   % %
% % % %%%%%%% %%% %%%%%%%%% %%% %%%%% %%%%% %%% %%%%%%%%% %%%%%%% %%%%%%%%%%%%% %%%%% %%% % %%%%% % %
% % %         %   %     %%%     %%%%% %%%%% %%% %%%%%     %%% %%% %%%%%%%%%%%   %   %     %   %     %
% % %%%%% %%%%% %%% %%% %%%%% % %%%%% %%%%% %%% %%%%%%%%%%%%% %%%%%%%%%%%%%%%%% % %%%%%%%%% % %%%%% %
% %   %   %%%       %   %%%%% %   %   % %%%   % %%%%%       %   %%%%%%%%%%% %%% % %%% %%%   %   %   %
%%% %%% %%%%%%%%%%%%%%%%%%%%% %%%%% %%% %%% %%% %%%%% %%%%% % % %%%%%%%%%%% %%% % %%% %%%%% %%% %%%%%
%%%     %%% %%%%%%%%%%%%%%%%% %       %     %%%   %%% % %%%   % %%%%%%%%%%% %           %%% %%% %%%%%
%%% %%%%%%% %%%%%%%%%%%%%%%%% % %%%%% % %%% %%%%% %%% % %%%%%%% %%%%%%%%%%% % %%%%%%%%% %%% %%% %%%%%
%%% % %%%   %%%         %%% %   %%%     % % %%%   %%%   % %%%%%     %%%     %   %%%%%%% %   %       %
%%% % %%% %%%%% %%% %%% %%% % %%%%%%%%%%% % %%% %%%%%%% % %%%%% %%% %%% %%% %%% %%%%%%% %%% % %%%%% %
%     %   %%%%% %%% %%%   %     % %%%         %     %%% %   %%%   % %   %%%     %%%%% % %%% % %     %
%%%%% %%% %%%%%%%%% %%%%% % %%% % %%%%%%%%%%%%%%%%% %%% % %%%%% % %%% %%%%%%%%%%%%%%% % %%%%% % %%%%%
%%%%%         %%%   %   % % %%%     %%%%%%%%%%%       % % %%%   % %%%     %%% %%%       %%%   % %%%%%
%%%%%%%%% %%% %%%%% % %%% % %%%%%%% %%%%%%%%%%% %%%%%%% % %%%%% % %%% %%%%%%% %%%%%%%%% %%% %%% %%%%%
%     %%% %%%   %%%   %%%     %%%   %%%           %%%%% %   %%% % %   %%%%%%%   %%%%%%%   % %%% %%%%%
%%%%% %%% %%%%% %%%%%%%%%%%%% %%% %%%%%%% %%%%%%% %%%%% % % %%%%% % %%%%%%%%% % %%%%%%%%% % %%%%%%%%%
%%%%%     %%%%%   %%%%%%%%%   %%% % %%%%%   %%%   %%%%%   % %%%%% %   %%% %%% %   % %%%%%     %%%%%%%
%%%%% %%%%%%%%%%%%%%%%%%%%%%% %%% % %%%%%%% %%% %%%%%%%%%%% %%%%% %%% %%% %%% %%% % %%%%%%% %%%%%%%%%
%%%     %%%%%%%%%%%%%%%%%%%%% %%%       %%%   %                 %             %%%   %%%%%%% %%%%%%%%%
%%%%%%%%%%%%%%%%%%%%%%%%%%%%%%%%%%%%%%%%%%%%%%%%%%%%%%%%%%%%%%%%%%%%%%%%%%%%%%%%%%%%%%%%%%%%%%%%%%%%%
