%%%%%%%%%%%%%%%%%%%%%%%%%%%%%%%%%%%%%%%%%%%%%%%%%%%%%%%%%%%%%%%%%%%%%%%%%%%%%%%%%%%%%%%%%%%%%%%%%%%%%
%%%   %%%%%%%%% %%%%%%%%%       %%%%%%%%%           %   %%%%%     %%%%% %%% %%%%%%%%%%% %%%%%%%%%%%%%
%%%%% %%%%%%%%% %%%%%%%%%%%%% % %%%%%%%%%%%%%%% %%% % % %%%%% %%%%%%%%% %%% %%%%%%%%%%% %%%%%%%%%%%%%
%%%%% %%% %%%       %%%       %   %%%   %%%%%%% %%%   % %%% %   %%% %%%     %%%%%%%%%%% %%%%%%%%%%%%%
%%%%% %%% %%%%%%% % %%%%% % %%%%% %%% % %%%%%%% %%%%%%% %%% % % %%% %%% % %%%%%%%%%%%%% %%%%%%%%%%%%%
%%%%% %         % %   %%% % %%%   %%% % %%%%% % %%%     %%%   % %%%     % %%%%%%%%%%%     %%%%%%%%% %
%%%%% % %%% %%% % % %%%%% %%%%%%%%%%% % %%%%% % %%% %%%%%%% %%% %%%%%%% %%%%%%%%%%%%% %%% %%%%%%%%% %
%%%     %%% %%% % % %%%               % %%%S%     %   %%%     % %%%     %%%%%   %%%   % %   %%%     %
%%%%% %%%%% %%% % %%%%% %%%%% %%%%% %%%%%%% %%%%% %%% %%%%%%%%% %%% %%% %%%%% % %%% %%% %%% %%%%%%% %
%%%%% %%%   %%%   %%%%%   %%%     % %%%%%%% %%%%% %%%     %%%       %%% %%%   %   %       %       % %
%%%%%%%%%%% %%% %%%%%%% %%%%%%% %%% %%%%%%% %%%%% %%% %%% %%% % %%%%%%%%%%% %%%%% %%% %%%%% %%%%% % %
%%%%%%% %%% %   %%%   % %%%%%%% %%%   %%% %   %     % %   %   % %%%     %%%   %%% %%% %%%%% %%% %   %
%%%%%%% %%% % %%%%% % % %%%%%%% %%% %%%%% %%% %%%%%%% %%% %%% %%%%% %%% %%%%% %%% %%%%%%%%% %%% % %%%
%%%%%       % % %%% %     %%%   %%%         %         %%% %%%   %     %       %   % %%%%%   %     %%%
%%%%% % % %%% % %%%%%%%%%%%%% %%%%%%%%% %%%%% %%%%%%%%%%% %%%%% % %%%%% %%%%%%%%% % %%%%% % %%%%% %%%
%     % % %%%   %%%     %%%%% %%%       %%%%% %%%%%%%   % %%%%%     %%%   % %%%%%         % %%%%%   %
%%%%%%% % %%%%%%%%% %%% %%%%%%%%% %%%%% %%%%%%%%%%%%% %%% %%%%%%%%% %%%%% % %%%%%%%%% %%% %%%%%%%%% %
%%%%%%% % % %%%%%   % %     %     %%%   %%%%%%%   %%% %       %%%%% %     % %%%       %%% %%%   %%% %
%%%%%%% % % %%%%% %%% %%%%% % %%% %%%%%%%%%%%%% %%%%% % %%%%%%%%%%%%% %%%%% %%% %%%%%%%%%%%%% %%%%% %
%%%%%   %   %%%   %           %%% %       %%%%% %     %   %%%%% %%%%%     %   %     %%%%%%%   %%%%% %
%%%%% %%%%%%%%% %%%%%%% %%%%% %%%%% %%% % %%%%% % %%% %%% %%%%% %%%%%%%%% %%% %%%%% %%%%%%% % %%%%%%%
%%%%%                 % % %%%   %%% %%% %   %%%   %%%   %         %%%%%%% %%%       %   %%% % %%%%%%%
%%%%%%%%% %%%%%%%%%%% % % %%%%% %%% %%%%% % %%% %%%%% %%%%%%%%%%% %%%%%%% %%% %%%%% % %%%%% %%%%%%%%%
%%%%%%%%% % %%%%% %%% %     %%%   %   %%% %   % %%%       %%%     %%%     %%% %%%%%   %%%   %       %
%%%%%%%%% % %%%%% %%% % %%% %%%%%%%%% %%% %%%%% %%%%% %%% %%%%% %%%%% %%% %%%%%%%%%%% %%%%% % %%%%% %
% %%%   % %         % % %%% %%%%%%%   % %       %%%%% %%% %%%%% %%%     % %%%%%   %%% %%%%% %   %%% %
% %%% %%% % %%%%% %%% %%%%% %%%%%%% %%% %%%%%%%%%%%%%%%%% %%%%% %%% %%% %%%%%%%%% %%%%%%%%% % %%%%% %
%   %       %%%%% %%% %%%   %%%   %       %%%   %   %%%   %%%%%   % %%% %%%   %%%   %%%     % %%%   %
% % % %%%%%%%%%%% %%% %%%%%%%%% % %%%%%%% %%% %%% % %%% %%%%%%%%% % %%% %%%%% %%%%% %%% %%% % %%% %%%
% % %   %%%%% %%%   %   %%%%%   %     %%%     %   %     %%%     % % %   %%%     %%%     %%% % %%%   %
% %%% %%%%%%% %%%%%%% %%%%%%% %%% %%%%%%% %%%%% %%%%%%%%%%%%% %%% %%% %%%%% %%%%%%%%% %%%%% % %%%%% %
%     %%%     %       %%% %%%   % %%%%%   %%%%%       %%%%%   %%%   % %%%   %%%%% %%%     %   %%%   %
% %%%%%%%%% % %%% %%% %%% %%%%%%% %%%%% %%%%%%%%%%%%% %%%%% %%%%%%% % %%% %%%%%%% %%%%% %%% %%%%% % %
%   %%%%%   %     %%% %%%             %             %   %%%       % %     %%%       %   %%% %%% % % %
%%% %%%%% %%%%%%% %%%%%%% %%%%%%% %%% %%%%%%%%%%%%% %%% %%% % %%%%% % %%% %%%%% %%%%% %%%%% %%% % %%%
%%% %%%   % %%%%%   %%%   %%%%%%% %%%     %%%       %%% %   %     % %   %   %%% %%%%%   %%%!    % %%%
%%%%%%% %%% %%%%% %%%%% %%%%%%%%%%%%%%%%%%%%% %%%%%%%%% % %%%%%%% % %%%%% %%%%% %%%%%%% %%%%%%%%% %%%
% %%%   %         %%%   %%%%%   %%%%%%%%%%%     %%%%% %   %   %%%   %%%   %%%%%       %   %%%%%%%   %
% %%% %%%%%%% %%%%%%%%% %%%%% %%%%%%%%%%%%%%%%% %%%%% %%%%% %%%%%%%%%%% % %%%%% %%%%% %%% %%%%%%% %%%
%   %   %%%%% %%%%%%%%%       %%%       %%%%%         %%%   %%%         %   %%% %%%   %   %%%%% %   %
% % %%% %%%%%%%%%%%%%%%%%%% %%%%% % %%% %%%%% %%%%% %%%%% %%%%% % % %%%%%%% %%% %%%%%%% %%%%%%% %%% %
% %     %%%%%%%   %%%       %%%   % %%% %%%   %%%%% %%%   %%%%% % % %%%%% % %%%   %%%   %%%     %   %
% %%%%% %%%%%%% %%%%%%% %%%%%%% %%% %%% %%%%% %%%%% %%% %%%%%%% % %%%%%%% % %%% % %%% %%%%% % %%% % %
% %%%           %%% %%% %%%%%   %%% % %   %%% %%% % %   %%%%%%% % %%% %     %%% % %   %%%   % %%% % %
% %%%%%%%%%%%%%%%%% %%% %%%%% %%%%% % %%% %%%%%%% % % % %%%%%%%%% %%% % %%%%%%% % % %%%%% %%% %%% % %
%       %%%%%%%%%     %   %%% % %   % %%% % %%%%%     % % %%% %%%   %   %%%%%%% %   % %%%   % %   % %
% %%%%% %%%%%%%%% %%% % % %%% % % %%% %%% % %%%%%%%%%%% % %%% %%%%% %%%%%%%%%%% %%%%% %%%%% % % %%% %
%   %%%           %     % %%%   % %%%     % %%%%%%% %%%           %               %%% %%%   % % %   %
%%%%%%% %%%%%%% % %%%%%%% %%%%%%% %%%%%%% % %%%%%%% %%%%%%%%%%%%% %%%%% %%%%% %%%%%%% %%% %%%%% %%% %
%%%%%%% %     % % %%%               %%%%%   % %%%     %%%%%%%%%%% %%%%% % %%% %%%%%   %   %%%%% %%% %
%%%%%%% % %%%%% %%%%%%%%%%%%% %%%%% %%%%%%% % %%%%%%% %%%%%%%%%%% %%%%% % %%%%%%%%% % %%% %%%%% %%% %
%     % % %%%%% %%% %       % %%%%% %%%%%%%     %%%%%   %%%     %   %%%     %%%     % %   %   %   % %
% %%% % % %%%%% %%% % %%%%% %%%%%%%%%%%%%%% %%%%%%%%% % %%% %%% %%% %%%%%%% %%% %%%%% % % % %%% % % %
% %%%     %%% %       %%%   %%%   %%% %%%   %%%%% %%% %       %   %   %%%     % %%%%%   %   %%% % % %
%%%%%%% %%%%% % %%%%%%%%% %%%%% %%%%% %%% %%%%%%% %%% %%% %%%%%%% % %%%%%%%%% % %%%%% %%%%%%%%% % % %
%%% %%% %%%%%     %       %%%%% %%%   %%%   %%%     % %%% %%%%%   % %%%%%%%%%     %%% %%%%%%%   % % %
%%% %%%%%%%%% %%%%% %%%%% %%%%% %%% % %%%%%%%%% %%%%% %%%%%%%%% %%% %%%%%%%%% %%%%%%%%%%%%%%% %%% % %
%%%   %%%%%     %   %     %%%%%     %                 %%%%%   %       %%%%%   %%%%%%%%% %%%%%   % % %
%%% %%%%%%% %%% % % %%% %%%%%%%%% %%% %%% %%%%%%%%%%%%%%%%% % %%%%%%%%%%%%%%% %%%%%%%%% %%%%% %%% %%%
%       %%% %%% % % %%% %%%%% %%% %%% %%% %%%%%%% %%%%%%% % %   %   %%%%%%%%% %%%   %%% %%%%% %%% %%%
% %%%%% %%% %%%%% %%%%%%%%%%% %%%%%%%%%%% %%%%%%% %%%%%%% % %%% % % %%%%%%%%%%%%% %%%%% %%%%%%%%% %%%
% %%% %   % %%%%% %%% %%%%%     %%%%%%%%% %%%         %%%     %   %   %%%%%%%%%           %%%     %%%
% %%% % %%% %%%%% %%% %%%%% % %%%%%%%%%%% %%% %%%%% % %%% %%%%%%%%% % %%%%%%%%%%%%%%%%%%% %%% % %%%%%
%     % %%% %%%%%   %       % %%%%%%%%%%% %%%   %%% % %%%   %%%     %   %%%%%%%%%%%%%     %   % %%%%%
% %%% % %%% %%%%%%% % %%%%% %%%%%%%%%%%%% %%%%%%%%%%% %%%%%%%%% %%% %%% %%%%%%%%%%%%% %%% % % %%%%%%%
% %%% %     %%% %%%   %%%%% %%%%%%%%%%%   % %%%%% %%%   %%%%%   % % %%% %%%%%%%       %%%   % %%%%%%%
%%%%%%% %%%%%%% %%%%%%%%%%% %%%%%%%%%%% %%% %%%%% %%%%% %%%%% % % % %%%%%%%%%%%%% % %%%%% %%%%%%%%%%%
%%% %%% %%%%%%%   %%%%% %%%     %%%%%   %%%       %%%%% %%%   % %     %%%     %%% %   %   %%%%%     %
%%% %%%%%%%%%%%%% %%%%% %%% % %%%%%%% %%%%% %%%%% %%%%% %%%%%%% %%%%% %%%%% % %%% %%% %%%%%%%%% %%% %
%%%   %%%     %%%       %   % %%%   %   %%% %%%%% %       %%%   %%%%%     % % %   %%%   %%% %%% %   %
%%%%% %%%%% % %%%%% % %%% % %%%%%%% %%% %%% %%%%% % %%% %%%%% % %%%%% %%% % % %%% %%%%% %%% %%%%% %%%
%%%%% %%%%% %   %%% %     % %%% %%%   %   % %%%     %%%       % %%%%% %%% % %   %   %       %%%   %%%
%%%%% %%%%% %%%%%%% %%%%%%% %%% %%% %%%%% %%%%%%%%%%%%%%% %%% %%%%%%%%%%% % %%% % %%% %%%%% %%% %%%%%
%           %%%%%   %%% %%%       %               %%%%%%% %%% %%%%%%%%% %   %%% % %   %%%%% %%% %%% %
%%% %%%%%%% %%%%% %%%%% %%%%% %%% % %%%%%%%%% %%% %%%%%%% %%% %%%%%%%%% %%% %%% % % %%%%%%% %%% %%% %
%%%   %%%       %         %%%   %   %%%   %%% %%%   %     %%%     %%%%%     %%% % % %%%   %   %     %
%%% % %%%%% %%%%%%% %%%%% %%%%%%%%%%%%% %%%%% %%%%% %%% %%%%% %%%%%%%%% %%%%%%% %%% %%%%% %%% %%% % %
%%% % %%%%% %%%%%   %%%   % %%%%% %%%   %%%%% %%%     %   %%% %%%%% %%% %%%%%       %%%%% %%%     % %
%%%%% %%%%%%%%%%%%%%%%% %%% %%%%% %%% %%%%%%%%%%%%%%% % %%%%% %%%%% %%%%%%%%%%%%%%%%%%%%% %%%%%%% %%%
%%%%%   %%%%%   %%%%% % %     %%% %%% %%%%%%%%% %%%%% % %%%%%       %%%%%%%%%%%         %       % %%%
%%%%% %%%%%%% % %%%%% % % %%%%%%% %%% %%%%%%%%% %%%%% %%%%%%%%% %%% %%%%%%%%%%% % %%%%% % % %%% % %%%
%%%%%     %%% %       % %               %%%       %%%   %   %%% %%%     %%%%%   %   %%%   % %%% % % %
%%%%%%% % %%%%% %%%%% % % %%% %%%%%%%%% %%% %%%%%%%%%%% %%% %%% %%%%%%% %%%%%%% %%% %%%%%%%%%%%%% % %
%%%%%%% %   %%% %%%   % %   %     % %%%     %%%%%%% %%%         % %%%%% %%% %%% %   %%%%%%%%% %%% % %
%%%%%%% %%% %%%%%%% %%% % %%%%%%% % %%%%%%% %%%%%%% %%%%%%%%%%%%% %%%%%%%%% %%%%% % %%%%%%%%% %%% % %
% %%%%% %%%   %%% %     % %       %         %%%   %       %%%   %     %%%     %%% % %           % % %
% %%%%% %%%%%%%%% % %%%%%%% %%% %%% %%%%%%%%%%% % % %%%%%%%%% % % % %%%%% %%% %%% % % %%%%%%%%%%% % %
%   %   %         % %       %   %%%   %%%%%%%   % %   %%%     %   % %%%   % %     %   %   %%%   %   %
% % % % % %%% %%%%% %%% % %%% %%%%%%% %%%%%%% %%% %%% %%% %%% %%%%% %%%%% % %%%%% %%%%% % %%% % %%% %
% %   %   %%% %%%%% %%% % %       %%% %%% %   %       %   %%% %       %%%   %%%%%       %     %     %
% %%%%%%%%%%% %%%%% %%%%% % %%%%%%%%%%%%% % % %%% %%%%% %%%%% %%% %%% %%%%% %%%%%%%%%%%%%%%%%%%%%%%%%
% % %%%     %   %   % %%% % %%%%%%% %%%     %   % %%%%% %   %   % %%% %%% %       %%%%% %%% %%%%%%%%%
% % %%% %%% %%% % %%% %%% %%%%%%%%% %%% %%%%%%% %%%%%%% % % %%% % %%%%%%% %%%%%%% %%%%% %%% %%%%%%%%%
%     % %   %%%   %%% %%%     %%%%% %%%     %%%       % % % %%% %   %%%%%     %   %%%     %   % %%%%%
%%%%% % %%%%%%%%%%%%% %%%%% % %%%%% %%%%%%% %%%%%%%%% % % % %%% %%% %%%%%%% %%% %%%%%%% % % % % %%%%%
%%%%% %       %%%         % %   %%%   %%%%%   %       %   %   % %   %       %%%   % %%% %   % %     %
%%%%% %%%%% % %%%%%%% %%% % %%% %%%%% %%%%% %%% % %%%%%%%%% %%% %%%%% % %%% %%%%% % %%% %%%%% % %%% %
%     %%%   % %       %%%   %%%   %%%   %%% %%% % %     %%% %%%   %%% %   % %           %     % %%% %
% %%% %%% %%% %%% %%% %%%%%%%%%%% %%% % %%%%%%% %%% % %%%%% %%% % %%% %%% %%% %%%%%%% %%%%%%% %%%%% %
% %%%     %       %%%   %%%%%%%%%     %   %%%       %       %%% %     %%%         %%% %%%%%%%       %
%%%%%%%%%%%%%%%%%%%%%%%%%%%%%%%%%%%%%%%%%%%%%%%%%%%%%%%%%%%%%%%%%%%%%%%%%%%%%%%%%%%%%%%%%%%%%%%%%%%%%
