%%%%%%%%%%%%%%%%%%%%%%%%%%%%%%%%%%%%%%%%%%%%%%%%%%%%%%%%%%%%%%%%%%%%%%%%%%%%%%%%%%%%%%%%%%%%%%%%%%%%%
%             %%%         %%% %%% %%%   %%%   %%%%%%%%% %%%%%       %%% %%%%% %%% %%%         %   %%%
%%%%% %%% % %%%%% %%% % % %%% %%% %%% % %%%%% %%%%%%%%% %%%%% %%% %%%%% %%%%% %%% %%%%% %%% % % % %%%
%%%%%   % % %     %%% % %         %   %   %%%   %%%%%%%   %%% %%% %%%%%   %%% %%%   %%%   % %   % %%%
%%%%%%% % %%% %%%%%%%%% %%%%%%%%% % % %%% %%% % %%%%%%% % %%%%%%% %%%%%%% %%% %%% % %%%%%%% %%% %%%%%
%%%%%%% %   %   %%%%%   %%%     % % % %%% %%% %   %%%%% % %%%%%   %%% %%%     %%% %   %%%%% %%% %%%%%
%%%%%%% %%% % %%%%%%% % %%%%%%% % % % %%% %%%%% %%%%%%%%% %%%%%%% %%% %%% %%% %%%%%%% %%%%% %%%%%%%%%
%%%%%%% %%%   %%%%%%% % %%%%%%%     % %%%   %%%     %%%%%   %%%%% %       %     %%%       % %%%%%%%%%
%%%%%%% %%%%%%%%%%%%% %%%%%%%%%%%%%%%%%%%%% %%%%% %%%%%%% %%%%%%% % %%% %%%%%%% %%% %%%%% % %%%%%%%%%
%%%%%%%   %%%%%%%%%   %%%%%   %%%%% %%%     %%%%%     %%% %%%%%%%   %   %%%%%%%   % %%% % %   %%%%%%%
%%%%%%%%% %%%%%%%%% %%%%%%% %%%%%%% %%% %%%%%%%%% %%% %%% %%%%%%% %%% %%%%%%%%%%% % %%% % % %%%%%%%%%
%%%%%%%   %%% %%%%% %%%     %%% %%%     % %%%%%%% %%%     %%% %%% %%% %%% %%% %     %%% %   %%%%%%%%%
%%%%%%%%% %%% %%%%% %%%%%%% %%% %%% %%%%% %%%%%%%%%%% % %%%%% %%%%%%% %%% %%% % %%% %%% % %%%%%%%%%%%
%%%%%%%%% %   %   % %%%         %%%   %%% %%% %%%%%   %               %%%     % %%% %%% % %%%%%%%%%%%
%%%%%%%%%%% % % % % %%% %%%%% %%%%% %%%%% %%% %%%%% %%%%%%%%% %%%%%%%%%%% %%% % %%%%%%% % %%%%%%%%%%%
%   %       %   %   %   %     %     %%%%%     %%%%%       %%% %       %   %%%   %%%%%%%   %%%%%%%%%%%
% %%% %%% % %%% %%%%%%% %%%%%%% %%%%%%%%%%% %%%%%%%%%%%%% %%% %%% %%%%% %%%%%%%%%%%%%%% %%%%%%%%%%%%%
%     %%% % %%% %%%   % %%%%%%%   %%%%% %%% %%%%%%%%%%%%%   % %%%   %         %%%     % %%%%%%%%%%%%%
% %%%%%%% %%%%% %%% % % %%%%%%%%% %%%%% %%% %%%%%%%%%%%%%%%%% %%%%% % %%% %%%%%%%%% % % %%%%%%%%%%%%%
% %%%%%     %   %%% %   %%%   %%% %   %         %%%         %   %%%   %%% %%%%%%%%% %   %%%%%%%%%%%%%
% %%%%% %%% %%%%%%% %%%%%%%%% %%% % % %%% %%%%% %%%%%%%%% % % %%%%%%%%%%%%%%%%%%%%%%%%%%%%%%%%%%%%%%%
% %%%   %%% %%%%%%% %%%%%%%%%     % %   % %%%     %%%%%   % % %%% %%%%% %%%%%%%%%%%%%%%%% %%%%%%%%%%%
%%%%%%% %%% %%%%%%% %%%%%%%%% %%%%% %%% % %%%%% %%%%%%% %%% % %%% %%%%% %%%%%%%%%%%%%%%%% %%%%%%%%%%%
%%% %%% %     %%%%%     %%%   %       %     %%% %%%%%%% %   %   %   %   %%%%%%%%%%%%%%%     %%%%%%%%%
%%% %%%%% %%% %%%%%%% %%%%% %%% %%%%% %%%%% %%%%%%%%%%% % %%% % % % % %%%%%%%%%%%%%%%%%%% %%%%%%%%%%%
%     %%% %       %%% %%%   % % %     %%%     %%%       %     % % %   %%%   %%%%%%%%% %%% %%%%%%%%%%%
% %%% %%% % %%%%% %%% %%%%% % % % %%% %%%%%%% %%%%%%%%% %%%%%%% % %%% %%% % %%%%%%%%% %%% %%%%%%%%%%%
% %%%     %   %%% %%%   %%% % % %   % %%%%%%%         % %%%%% %   %   %   %   %%%%%         %%%%%%%%%
%%%%% %%%%%%%%%%%%%%% % %%% % % %%% %%%%%%%%% %%%%%%% % %%%%% %%%%% %%%%%%%%% %%%%% %%%%% % %%%%%%%%%
%     %%%%%%%%%   %   % %%% %     %       %%% %%%%%%%   %         % %%%   %%% %%%   % %%% %   %%%%%%%
% %%% %%%%%%%%% % % %%% %%% % %%%%% %%%%% %%%%%%%%%%%%%%%%%%%%% %%% %%% % %%% %%%%% % %%%%% % %%%%%%%
% % % %   % %%% %S% %%% %%% % %%%%% %%%%%   %%%%%%%%%%%%%%%%%%% %%% %   % %%%   %%%     %   % % %%%%%
% % % % % % %%% %%%%%%% %%% %%%%%%%%%%%%% %%%%%%%%%%%%%%%%%%%%% %%% % %%% %%% %%%%%%% %%% %%% % %%%%%
% %     %     %   %%%   %%%   %   %%%   % %%%%%%%%%%%%%       %     % %   %%% %%% %%% %%% %         %
% %%% %%%%%%% %%% %%% %%%%%%% %%% %%% % % %%%%%%%%%%%%% %%%%%%% %%%%% % %%%%% %%% %%%%%%% % %%%%% %%%
% %%% %%%     %%% %%%     %%%         % %     %%%%%       %%%%%       %   %%%         %   % %%%%% %%%
% %%%%%%%%%%%%%%% %%%%%%% %%%%%%%%%%%%% %%%%% %%%%%%% %%% %%%%%%%%%%%%%%% %%%%% %%%%% %%% %%%%%%%%%%%
% %%%%%%%   %%%   %           % %%%       %%% %%% %%% %%%   %%%         %       %     %%%     %%%%%%%
% %%%%%%% % %%% %%%%% %%%%%%% % %%%%% %%% %%% %%% %%%%%%% %%%%%%%%%%%%% %%%%%%%%% %%%%%%%%% %%%%%%%%%
% %%%%% % %   %   %%% %%%%% %     %%% %%%     %     %%%   %%% %%%%%%%     % %%%   %         %%%%%%%%%
% %%%%% % %%% % %%%%% %%%%% % %%%%%%%%%%%%%%%%% %%% %%% %%%%% %%%%%%% %%% % %%%%% %%%%%%% %%%%%%%%%%%
%         %%%   %%%     %%%   %%%%% %%% %%%     %%%   % %%%   %%%     %%%   %%%%%       % %%%%%%%%%%%
% %%% %%%%%%%%%%%%%%% %%%%% %%%%%%% %%% %%%%% % %%%%% % %%% % %%% %%% %%% %%%%%%%%%%%%% % %%%%%%%%%%%
% %%%   %%%     %%%%% %%%%%     %%%           %   %%%       %     %%% %%% %%%   %%%     %   %%%%%%%%%
%%%%%%% %%% %%% %%%%% %%%%%%% %%%%%%% %%% %%%%%%%%%%%%%%%%%%% %%%%%%% %%%%%%% % %%% %%%%%%% %%%%%%%%%
%%%%%%% %%%   % %%%     %%%   %%% %%% %%% %     %%%%%%%%%     %%%%%%%   %%%   %   % % %%%%%     %%%%%
%%%%%%%%%%%%% % %%%%% %%%%% %%%%% %%%%%%% % %%% %%%%%%%%%%% %%%%%%%%%%% %%%%% %%%%% % %%%%%%%%% %%%%%
%%%%% %%%%%%% %   %%%   %           %%%     %%% %     %%%%% %%%   %%%%% %%%   %%%%% %       %%% %%%%%
%%%%% %%%%%%% % %%%%%%% %%%%%%%%% %%%%% %%%%%%% % %%% %%%%%%%%% %%%%%%%%%%% %%%%%%% % %%%%% %%% %%%%%
%%%           % %%%     %%%%%   % %     %%%%%%%   %   %%% %%%   %%% %%%%%%%     %%%   %   %     %%%%%
%%%%% %%%%%%%%% %%% % %%%%%%% %%% % %%%%%%%%%%%%%%% %%%%% %%%%% %%% %%%%%%% %%% %%%%%%% %%% %%% %%%%%
% %%% %   %%%   %!  % %%%     %%% % %     %%%%%%%   %%%     %%%         %%% %   %%%%%   %%% %%% %%%%%
% %%% %%% %%% %%% % %%%%% %%% %%% % %%% %%%%%%%%% %%%%% %%%%%%% %%%%%%% %%% % %%%%%%% %%%%%%%%% %%%%%
% %%%     %%%     % %%%   %%%     % %   %%%%%               %%%     %   %%% %     %   %%%%%%%%%     %
% %%%%%%% %%%%%%%%% %%%%%%%%% %%%%% % % %%%%%%%%%%%%%%% %%% %%% %%% %%% %%% %%% % % %%%%%%%%%%%%%%% %
%       %   %%%%%%% %%%%%%%%% %%%   % %     %%%%% %%%%%   %     %%%   % %%% %%% %   %%%%%%%%%%%%%   %
% %%% % %%% %%%%%%% %%%%%%%%% %%% %%% %%%%% %%%%% %%%%%%%%%%%%%%%%%%% % %%%%%%% %%%%%%%%%%%%%%%%% %%%
% %%% % %%%   %%%   %%%%%%%     % %%%     % %%%   %%%%%%%%%%%%%%%%% % % % %%% %   %%%   %%%%%%%   % %
% %%% % %%% %%%%% %%%%%%%%% %%%%% %%% %%% %%%%% %%%%%%%%%%%%%%%%%%% % % % %%% % % %%% %%%%%%%%% %%% %
% %%% % %%% %%%       %%%   % %%% %%% %%%           %%%%%%%%%%%%%%% % %     % % %       %%%%% % %   %
%%%%% % %%% %%%%%%%%% %%%%% % %%% %%% %%%%%%%%%%% %%%%%%%%%%%%%%%%% % %%%%% % % %%%%%%% %%%%% % %%% %
%     %   % %%%%%     %%%%%   %   %%%       %%%   %%%%%%%%%%%%%%%%% %   %%%   % %   %%%     % % %%% %
% % %%%%%%% %%%%% %%%%%%%%% %%% %%%%%%% %%% %%% %%%%%%%%%%%%%%%%%%% %%% %%%%%%% % % %%% %%% % % %%% %
% % %%%     %   % %%%   %%% %     %%%%% %%%   % %     %%%%%%%%%%%     %           %   % %   % % %%% %
% %%%%% %%%%% % % %%% % %%%%% %%%%%%%%% %%%%% % % % %%%%%%%%%%%%%%% %%%%% %%%%%%%%%%%%% % %%% % %%% %
%   %%%   %%% % %     % %%%%%   %%%%% % %%%%% % % %   %   %%%       %%%%%     %%%%%     %     % %   %
%%% %%%%% %%% %%% %%%%% %%%%% %%%%%%% % %%%%%%% % %%% % % %%%%% % %%%%%%%%%%%%%%%%% %%%%% %%%%% % %%%
%%%   %%% %%% %%% %%%     %   %%%         %%%%%   %%%   %   %%% % %%%%%%%%%%%%%     %%%   %       %%%
%%% % %%% %%% %%% %%% %%% % %%%%% %%% %%%%%%%%% %%%%%%%%%%% %%% %%%%%%%%%%%%%%% %%%%%%% %%% %%%%%%%%%
%   % %%% %%% %%% %%% %%% %   %   %%%   %%%   % %%%%% %%% % %   %%%%% %%%   %%%     %%% %%%   %%%%%%%
% %%% %%% %%% %%%%%%% %%%%%%% %%% %%%%%%%%% %%% %%%%% %%% % % % %%%%% %%%%% %%%%%%% %%%%%%% %%%%%%%%%
% %%%         %%%%%%%       % %%%   %%%%%     %       %   %   %   %%%   %%%   %%%   %%%%%   %%%   %%%
% %%%%% %%% %%%%%%%%% %%% % % %%% %%%%%%%%%%% % %%%%% % % %%%%% %%%%%%% %%% % %%% % %%%%% %%%%%%% %%%
% %%%%% %%% %%%%% %%% %%% %   %%% %%%   %%%%%   %%% % % % %%%%% %%%   % %%% %     % %%%   %%% %%%   %
%%%%%%% %%%%%%%%% %%%%%%% %%%%%%% %%% %%%%%%%%%%%%% % % %%%%%%% %%% % % %%%%%%%%% %%%%%%% %%% %%% % %
%%%%%%% %%%%%     % %%%%% %%% %%% %   %%%%%%%%%%%%%     %%%     %%% %     %%%%%%%     %%%     %   % %
%%%%%%% %%%%% % % % %%%%%%%%% %%% % %%%%%%%%%%%%%%%%%%% %%% %%%%%%% % %%%%%%%%%%%%%%% %%%%%%% %%% % %
%%%%%%%   %   % %       %%%%% %%%   %%%%%%%%%%%   %%%%% % %   %     % %%%%%   %%% %%%   %%%   %%% % %
%%%%%%%%% % %%% %%%%%%% %%%%% %%% %%%%%%%%%%%%% %%%%%%% % %%% % %%% %%%%%%% %%%%% %%%%% %%%%% %%%%% %
%   %%% % % %   %     %   %%%     %%%%%%%%%%%   %%%%% %   %%%   %%% %%% %%% %%%%% %%%%%   %%%   %%% %
% %%%%% % %%% %%% % %%%%% %%%%% %%%%%%%%%%%%% %%%%%%% %%% %%%%%%%%% %%% %%% %%%%% %%%%%%% %%%%% %%% %
%           %   % % %%% % % %%% %%%%%%%%%%%             % %%%%%%%%% %%% %%%           %%%     %   % %
% %%%%% %%% %%% % %%%%% % % %%%%%%%%%%%%%%% %%% %%%%% %%% %%%%%%%%% %%% %%%%%%%%%%% % %%% % %%%%% % %
%   %%% %%%     % %%% %     %%%%%%%%%%%%%   %%% %   % %     %   %%% %         %     % %%% % %%%   % %
% %%%%% %%% %%%%% %%% % %%%%%%%%%%%%%%%%%%%%%%%%% % % % %%% %%% %%% % % %%%%% % %%% %%%%%%% %%% %%% %
% %%%%% %%% %%%%%       % %%%%%%%%%%%     %%%     % %   %%%   %   %   %     %   % % %%% %%% %       %
%%%%%%%%%%%%%%%%%%%%% %%% %%%%%%%%%%% %%% %%%%% %%% %%%%%%%%% %%% %%%%%%%%% %%%%% % %%% %%% % %%% %%%
%%%%% %%% %%%%%%%%%%% %%%   %%%%%%%   %   %     %   %%%%%%% %     %%%%%     %%%     %   %%%   %%% %%%
%%%%% %%% %%%%%%%%%%% %%%%% %%%%%%% %%%%% % %%%%% %%%%%%%%% % %%% %%%%% %%%%%%% %%% % %%%%%%% %%%%%%%
% %%% %%%   %%% %%% % % %%%   %%%%% %%%%%   %%%%% %%% %%%     %%% %%%     %%%   %%%   %%%%%%%   %%%%%
% %%% %%%%% %%% %%% % % %%%%% %%%%% %%%%%%%%%%%%% %%% %%% %%%%%%% %%%%%%% %%%%%%%%%%%%%%%%%%%%%%%%%%%
%     %%%%%   % %%%   %         %   % %%%   %%%   %   %%%   %%%   %%%%%%%     %%%%%%%%%%%%%%%%%%%%%%%
% %%% %%%%% % % %%% %%% %%%%%%% % %%% %%% %%%%% %%% % %%%%% %%%%% %%%%%%%%%%% %%%%%%%%%%%%%%%%%%%%%%%
% %%%       %     %     %%% %     %           %   % %     % %%%%% %%% %%%%%%% %%%%%%%%%%%%%%%%%%%%%%%
% %%%%% %%% % %%%%% %%% %%% % %%%%%%% %%% %%% %%% % %%%%% %%%%%%%%%%% %%%%%%% %%%%%%%%%%%%%%%%%%%%%%%
%   %%% %%% % %     %%% %%%   %%%%%%% %%% %%%   %   %   %           %     %   %%%%%%%%%%%%%%%%%%%%%%%
% %%%%%%%%% %%% %%% %%%%%%%%%%%%%%%%% %%% %%%%% % %%% %%% %%% %%%%% % %%% % % %%%%%%%%%%%%%%%%%%%%%%%
% %%% %%%   %   %%%   %%%%%%%%%%%%%%% %%% %%%%%   %%%     %%% %%%%%   %%%   % %%%%%%%%%%%%%%%%%%%%%%%
% %%% %%%%% % %%%%% %%%%%%%%%%%%%%%%%%%%% %%%%% %%%%%%%%% %%%%%%%%%%%%%%%%%%% %%%%%%%%%%%%%%%%%%%%%%%
%     %%%%%   %%%   %%%%%%%%%%%%%%%%%%%     %%%     %%%%%   %%%%%%%%%%%%%%%%% %%%%%%%%%%%%%%%%%%%%%%%
%%%%%%%%%%%%%%%%%%%%%%%%%%%%%%%%%%%%%%%%%%%%%%%%%%%%%%%%%%%%%%%%%%%%%%%%%%%%%%%%%%%%%%%%%%%%%%%%%%%%%
