%%%%%%%%%%%%%%%%%%%%%%%%%%%%%%%%%%%%%%%%%%%%%%%%%%%%%%%%%%%%%%%%%%%%%%%%%%%%%%%%%%%%%%%%%%%%%%%%%%%%%
%%%%%%%%%%%%%   %   %%% %%% %   %%%%%%%%% %%% %%%     %%% %%%   %%%   %%%%% %%%%%%%%%%%     %%%   %%%
%%%%%%%%%%%%% %%% % %%% %%% % % %%%%%%%%% %%% %%% %%% %%% %%%%% %%% %%%%%%% %%%%%%%%%%% %%% %%% %%%%%
%%%%%%% %%%       % %%% %%% % %   %%%%%%%         %%% %%%   %%%     %%%%%%% %%%%%%%%%   %%% %%%     %
%%%%%%% %%%%% %%%%% %%% %%% % % % %%%%%%%%%%% %%% %%%%%%%%% %%%%% % %%%%%%% %%%%%%%%% %%%%% %%%%% %%%
%%%%%     %%%   %   %%% %%%   % %   %%%%%%%%% %%%                 %   %%%     %%%%%%%   %%%       %%%
%%%%% %%%%%%%%%%% %%%%% %%% %%% % %%%%%%%%%%%%%%% %%% %%% %%%%% %%% %%%%% %%% %%%%%%%%%%%%% %%% %%%%%
% %%% %%%         %%%   %%% %   % %%%       %%% % %%% %%% %%%%% %%% %%%   %%%         %%%   %   %%% %
% %%% %%% %%% %%%%%%% % %%%%% %%%%%%% % %%%%%%% % %%% %%%%%%%%% %%%%%%%%%%%%% %%% %%% %%%%%%% %%%%% %
% %%% %   %%%   %%%   %   %%%   %%%%% % %%%%%%%   %%%   %%% %   %%%    S%%%%% %%% %%%   %%%%%       %
% %%% % %%%%%%% %%% %%% %%%%%%% %%%%%%% %%%%%%%%% %%% %%%%% % %%%%% %%%%%%%%% %%%%%%%%% %%%%% %%% %%%
%     %   %%%%%     % % %%%%%%% %%% %%%       %%% %%%   %%%   %%% % % %%%           %%% %%%   %%% %%%
% %%% %%% %%%%% %%% % % %%%%%%% %%% %%% %%%%% %%%%%%%%% %%%%%%%%% % % %%%%% %%%%% %%%%% %%%%%%%%% %%%
% %%% %     %%% %%%   %   %%%%%         % %%% %%%%%%%%%     %%% %   % %%%%%   %   %%%               %
% %%%%% %%%%%%%%%%%%%%% %%%%%%%%% % %%%%% %%% %%%%%%%%% %%% %%% % %%% %%%%% %%% %%%%% %%%%%%% %%% %%%
%   %   % %%%%%%% %%%%% %%% %%%%% % %%% %     % %%%%%     %       %   %%%   %   %%% %   %%%   %%% %%%
% % % %%% %%%%%%% %%%%% %%% %%%%% %%%%% % %%%%% %%%%%%%%% %%%%%%%%% % %%%%%%% %%%%% %%% %%%%% %%%%%%%
% % %     %%%%%           %       %%%%%   %%%     %%%%% % %%%       %   %%%%%   %     %   %%% %%%%% %
%%% %%%%% %%%%% %%% %%%%%%% % %%% %%%%%%% %%%%% %%%%%%% % %%%%% %%%%%%% %%%%%%% %%%%% %%% %%%%%%%%% %
%%%   %   %%%   %%% %%%     %   %   %%%%%   %%%       %   % %%% %     %         %%%%%     % %%%     %
%%% %%% %%%%%%% %%% %%% %%%%%%% %%% %%%%%%% %%% %%%%% % %%% %%% % %%%%%%%%%%%%%%%%%%%%%%% % %%% %%%%%
%       %%%%%%%   % %%% %   %%% %%%     %%% %%% %     %         %             %%% %%%%%%%   %     %%%
%%% %%%%%%%%%%%%% %%%%% %%% %%% %%%%% %%%%% %%%%% % %%% %%%%%%%%% %%%%%%% %%% %%% %%%%%%%%% % %%% %%%
%%% %%%%%%%%%     %%%     % %%% %%%   %%%   %     % %%% %%%         %%%   %   %     %       % %%%   %
%%%%%%%%%%%%% %%%%%%%%%%% % %%% %%%%%%%%%%% %%% %%% %%%%%%% %%%%%%%%%%% %%%%%%% % %%% %%% %%%%%%%%% %
%%%%%%%%%%%         %%% % %   % %     %%%%% %   %%% %%%%%     %   %     %%%     %     %%%     %%%   %
%%%%%%%%%%% %%%%%%% %%% % % % % % %%% %%%%% % %%%%%%%%%%%%%%%%% % % %%%%%%% %%%%%%%%%%%%%%%%% %%% %%%
%%%%%%% %%% %   %%%     %   % %   %   %%% % %     %%%         % %   %%%%%%%   %     %%%%% %%% %   %%%
%%%%%%% %%% %%% %%% % %%% %%%%%%%%% %%%%% % %%% %%%%%%% %%%%% % % %%%%%%%%%%% %%% %%%%%%% %%% % %%%%%
%%%%%%% %%% %%% %%% %     %%%%%%%%% %%%%%   %%% %%%%%%% %%%%%   % %%%%%%%         %%%     %%%   %%% %
%%%%%%% %%% %%% %%%%%%% %%%%%%%%%%% %%%%% %%%%% %%%%%%% %%%%%%%%% %%%%%%%%%%%%% %%%%%%% % %%%%% %%% %
%%%   %   % %     %%%%% %%%       % % %         %%%%%   %   %%%   %%%   %%%%%   %%%%%%% % %%% %     %
%%% %%% % % % % %%%%%%% %%% %%% %%% % % %%%%%%% %%%%%%% %%% %%% %%%%% % %%%%% %%%%%%%%%%% %%% % %%%%%
%%% %%% % % % % %%%   % %   %%% %   % %   %%%%%     %%% %%%     %   % %       %   %%% %%%   %   %%%%%
%%% %%% % % % % %%%%% % % %%%%% % %%% % %%%%%%%%%%%%%%% %%%%%%% % %%% %%%%%%%%% % %%% %%% %%% %%%%%%%
%       %     %   %%% %   %   % % %%%   %%%         %%%   %%%%%   %%%   %%%%%   % %%% %%% %%% % %%%%%
% %%%%%%%%%%%%%%% %%% %%% % % %%% %%% %%%%%%% %%%%% %%% % %%%%%%% %%%%% %%%%%%% %%%%% %%% %%% % %%%%%
% %         %%%   %%%     % %   % %       %%% % %%%   % % %%%   %   %%%   %%%%% %%%   %%%   %   %%%%%
% % %%% %%%%%%%%%%%%% %%%%% %%% % % %%%%%%%%% % %%%%% % % %%%%% % %%%%%%% %%%%% %%%%% %%% % %%% %%%%%
%   %%% %%%%% %%%%%%%   %%% %     % %%%%%%%       %%%   %   %%%   %%% %%% % %%%   %%% %%% %   % % %%%
%%% %%% %%%%% %%%%%%%%%%%%% % %%%%% %%%%%%%%%%%%% %%%%%%% %%%%%%%%%%% %%% % %%% %%%%% %%%%% % % % %%%
%   %%%       %%% %%%%%%%   % %%%   % %%% %%%%%%% %       %%%%%%%%%     %  !  %         %%% %     %%%
%%% %%%%%%% %%%%% %%%%%%% %%%%%%%%% % %%% %%%%%%% % %%% %%%%%%%%%%% % %%%%%%% %%%%% %%% %%% %%%%%%%%%
%%%   %%%%% %%%%%         %%%%% %%%     %   %%%   % %   %%%%%%%%%   % %%%%%%%   %   %   %%% %%%%%%% %
%%%%% %%%%% %%%%% %%%%% %%%%%%% %%%%%%% %%% %%% %%% % %%%%%%%%%%% %%% %%%%%%%%% % %%% %%%%%%%%%%%%% %
% %%% %%% % %%%   %%%%%         %%%     %     %   % % %%%%%   %     %   %       % %%% %%% %%%%%     %
% %%%%%%% % %%%%%%%%%%%%% %%%%% %%% %%%%% %%%%% %%% %%%%%%% % % %%% %%% % %%%%%%% %%%%%%% %%%%% %%% %
%   %%%%%     %%%%%%%%%%%   %%% %         %%%   %%% %%%%%%% %   %%% %%%   %%%%%                 %%% %
% % %%%%%%%%% %%%%%%%%%%% %%%%% %%%%% %%%%%%% %%%%% %%%%%%% %%%%%%%%%%%%%%%%%%%%%%%%%%%%%%%%%%% %%% %
% % %%% %%%   %%%%%%%     %%%   %%%%% %%%%%%% %%%   %     % %%%%%%%%% %%%%%%%%%               % %   %
% % %%% %%%%% %%%%%%%%% %%%%%%% %%%%%%%%%%%%% %%% % % %%% % %%%%%%%%% %%%%%%%%% %%%%%%% %%%%% % %%%%%
% %     %%%%%   %%% %%% %%% %%%     %%% %%%   %%% %   %%% %     %%%     %%%%%   %%%%%%% %%%%%   %%%%%
%%% %%%%%%%%%%%%%%% %%%%%%% %%% %%% %%% %%% %%%%%%% %%%%% %%%%% %%% %%%%%%%%% % %%%%%%%%%%%%% %%%%%%%
%%%       %%%%%%%%% %%%%%%%     %%%     %%% %   %%% %%%   %%%%% %%% %%%%%   % %   %%% %%%     %%%   %
%%%%%%% %%%%%%%%%%% %%%%%%% %%%%%%%%% % %%% % % %%%%%%%%% %%%%% %%% %%%%%%% % %%% %%% %%% %%%%%%% % %
%%%%%%%     %               %   % %%% % %     % %%%%%%%%%   %%%       %%%%%   %%% %%% %%%   %%%   % %
%%%%%%% %%% % %%%%%%%%%%%%%%% % % %%%%% % %%% %%%%%%%%%%%%% %%%%% %%%%%%%%% %%%%% %%% %%% %%%%% %%% %
%%%%%   %%%   %%%%% %%%%%%%   %     %%%   %%% %%%   %%%%%%%     % %%%%%   % %%% %   %     %%%   %   %
%%%%%%% %%%%%%%%%%% %%%%%%% %%%%% %%%%%%%%%%% %%% % %%%%%%%%% % % %%%%% % % %%% %%% % %%%%%%%%% %%%%%
%%%%%%% %%%%%%%%%%% %%%%%   %%%%% %%%%%   %%% %%% %     %%%   % %   %%% % % %     % %       %%%   %%%
%%%%%%% %%%%%%%%%%% %%%%%%% %%%%% %%%%% %%%%%%%%% %%%%%%%%% %%%%%%% %%% % % % % %%% %%%%% %%%%%%% %%%
%%%%%%% %       %%% %   %%% %%%%% %%%   %%%%%%%%% %%%%%     %%%%% %     % %   % %%% %%%   %%%       %
%%%%%%% %%% %%%%%%% % % %%% %%%%%%%%%%% %%%%%%%%% %%%%% %%% %%%%% %%%%%%% %%%%%%%%% %%%%% %%% %%%%% %
%%%%%%% %%% %%%%%     %       %%%%% %%%       %%%   %%% %   %%%     %%%     %%%       %%%   % %%%%% %
%%%%%%% %%% %%%%%%%%%%% %%%%% %%%%% %%% %%%%% %%% % %%% %%%%%%% %%%%%%%%%%% %%% %%%%%%%%%%% % %%%%%%%
%%%%%   %%%       %%%%% %%%         %%% %     %   %   %           %%% %%%%% %   %%%%%%% %%%       %%%
%%%%%%% %%% %%%%% %%%%% %%% %%%%% %%%%% % %%% %%%%% % %%%%%%%%%%% %%% %%%%% %%% %%%%%%% %%%%%%%%% %%%
%%% %%% %%% %%%   %     %%% %%%   %%%%% % %     %%% % %%%%%%% %       %%% % %%% %%% %%%   %         %
%%% %%% %%% %%% %%% %%% %%% %%%%% %%%%%%% %%%%% %%%%% %%%%%%% % %%% %%%%% % %%% %%% %%% % % %%%%% %%%
%   %%% %   %%% %%% %%% %%%   %%%         %%% % % %%%         % %%% %%% %   %   %%%     %     %%% %%%
%%% %%% % %%%%% %%%%%%%%%%%%% %%%%%%% %%%%%%% % % %%% %%%%% %%% %%%%%%% % %%% % %%% %%% %%%%%%%%%%%%%
%   %%%   %%%     %%%%%%%%%%%   %%%%% %%%   %   % %%% %%%%% %%% %%%       %   % %%% %%% %%% %%% %%%%%
% %%%%%%%%%%% %%% %%%%%%%%%%% % %%%%%%%%% % % %%% %%% %%%%%%%%% %%% %%%%%%% % %%%%%%%%% %%% %%% %%%%%
%     %%%%%   %%%   %%% %%%%% % %%%%%%%   %       %%%     %%%       %%%%%   %     %%%%%         %%%%%
%%%%% %%%%%%% %%%%%%%%% %%%%%%% %%%%%%%%%%% %%%%%%%%% %%% %%%%%%%%%%%%%%% %%%%% %%%%%%%%% %%% %%%%%%%
%%%%%     %%%   %%%%%       %%% %%%%%%%%%%% %%%%%%%%% %   %%%%%   %%%%%   %%%%% %%%%% %%% %%% %%%%%%%
%%%%% %%% %%%%% %%%%% %%%%% %%% %%%%%%%%%%% %%%%%%%%% %%% %%%%%%% %%%%%%%%%%%%% %%%%% %%%%%%%%%%%%%%%
%%%%% %%%     %   %%% %%%%% %         %%%%%     %%%   %%% %%%         %%%%%         %           %%%%%
%%%%% %%%%%%% %%% %%% %%%%% %%% %%%%% %%%%%%% %%%%%%% %%%%%%% %%% %%%%%%%%%%% %%%%% % %%%%%%% %%%%%%%
%%%%%     %%%       % %%%       %     %%% %%% %%%%%     %%%   %   %%%%%%% %%% %%%%% % %%%     %%%%%%%
%%%%%%% %%%%% %%%%% % %%%%%%%%% %%%%%%%%% %%% %%%%% %%%%%%% %%% %%%%%%%%% %%% %%%%% % %%% % %%%%%%%%%
%%%     %%%     %%% %     %%%%% %   %%%       % %%% %%%%%%% %   %%%           %%%   % %   % %%%%%%% %
%%%%%%% %%%%%%%%%%% %%%%% %%%%%%% % %%% %%%%%%% %%% %%%%%%% %%%%%%%%%%%%%%% %%%%% %%% % % %%%%%%%%% %
% %%%%%   %%%%%%%   %         %%% % %%% %%%   % %     %%%   %%%%%%%%%%%     %%%   %%% % % %%% %%%%% %
% %%%%% %%%%%%%%% %%% %%%%%%% %%% % %%% %%% % % % %%% %%% % %%%%%%%%%%% %%%%%%%%%%%%% % %%%%% %%%%% %
% %%%   %%%%%%%   %   %%%%%%% %%% % %%%     % %   %     % %   %%%%%         %       % %             %
% %%%%%%%%%%%%% %%%%% %%%%%%%%%%% % %%%%%%%%% % %%% %%% %%%%% %%%%%%% %%%%% % %%%%% % %%%%% % %%%%% %
%   %%%%% %%% % %%%%%       %   % %   %%%%% % %   % %     %       %%%   %   % %%%%%   %%%%% %   %%% %
% %%%%%%% %%% % %%%%%%% % %%% % % % %%%%%%% % % %%% % %%% % %%% %%%%%%%%% %%% %%%%% %%%%%%%%%%% %%% %
% %%%               %%% %     %   %     %%%   % %%% % %%% % %%% %%%%%%%%%     %%%%% %     %%%   %   %
% %%% %%% %%% %%%%% %%%%%%%%% %%%%%%% %%%%% %%%%%%% % %%% % %%%%%%%%%%%%%%% %%%%%%%%% %%% %%% %%%%% %
% %%% %%% %%% %%% %         % %%%%%   %%%   %       % %%% %   %%% %%%     % %%%%%     %     %     % %
% %%%%%%% %%%%%%% %%%%%%%%% %%%%%%% %%%%%%% %%% %%% %%%%% % %%%%% %%%%% % %%%%%%% %%% %%%%% %%%%% %%%
%   %%%     %%%     %%%%%     %     %%% %%%   % %%% %%%   % %         % %     %%% %%% %%%     %%% %%%
%%% %%%%%%% %%%%%%% %%%%%%%%% %%% %%%%% %%%%% % %%%%%%%%% % % %%%%% % % %%%%% %%% %%%%%%% %%% %%% %%%
%%%   %%%%%   %%%%%     %%%%%     % %%% %%% % %   %%% %%% %   %     %   %%%%% %%%     %   %%%   %   %
%%% %%%%%%% %%%%%%% %%%%%%%%%%%%%%% %%% %%% % % %%%%% %%% % %%% %%%%% %%%%%%% %%%%%%% %%%%%%%%% % %%%
%%%         %%%%%%% %       %       %%%         %%%   %%% % %   %%%%% %%%         %%% %%%%%%%%%   %%%
%%% %%%%%%% %%%%%%% % %%% % % %%% %%%%% %%%%%%% %%%%% %%% %%% %%%%%%%%%%% %%%%%%% %%% %%%%%%%%% %%%%%
%%%   %%%%% %%%%%     %%% %     %       %%%%%   %%%%%         %%%%%%%%%       %%%     %%%%%%%%% %%%%%
%%%%%%%%%%%%%%%%%%%%%%%%%%%%%%%%%%%%%%%%%%%%%%%%%%%%%%%%%%%%%%%%%%%%%%%%%%%%%%%%%%%%%%%%%%%%%%%%%%%%%
