%%%%%%%%%%%%%%%%%%%%%%%%%%%%%%%%%%%%%%%%%%%%%%%%%%%%%%%%%%%%%%%%%%%%%%%%%%%%%%%%%%%%%%%%%%%%%%%%%%%%%
%   %%%%%           %   %%%     %       %%%   %%%%%       %%% %%%     %%%%%%%%% %           %%%%%%%%%
% %%%%%%% % %%% %%% %%% %%% % % % %%% % %%% %%%%%%%%% %%% %%% %%% %%% %%%%%%%%% % %%%%% %%% %%%%%%%%%
% %%%     % %%% %%%     %   % % %   % %     %%%   %%% %%% %       % %   %%%   %     %%% %   %%%%%%%%%
% %%% %%%%% %%% %%%%%%% % %%% %%% %%% % %%%%%%% %%%%% %%%%% % % %%% % %%%%% % % %%%%%%%%% %%%%%%%%%%%
% %%% %%%%% %%% %%%     % %%%     %%% % %%%%%%% %%%         % % %%%   %%%%% % % %%%%%%%%%         %%%
% %%% %%%%% %%%%%%% %%%%% %%%%% %%%%% %%%%%%%%% %%% %%% %%%%% %%%%%%%%%%%%% %%% %%%%%%%%% %%% % %%%%%
%     %%%     %%%       % %%%%%     % %%% %     %%% %%% %%%%% %%%%%%%%% %%%   % %%%   %%% %%% %     %
% %%%%%%% %%% %%%%% %%%%% %%%%%%%%%%% %%% % %%% %%%%%%%%%%%%% %%%%%%%%% %%%%% % %%%%% %%%%%%% %%% % %
% %   %%%   %   %%% %%%   %   %%%%%%%   %   %S        %%%       %         %%%   %     %%%%%   %%% % %
% % % %%%%% %%%%%%%%%%% %%% % %%%%%%% %%% %%%%%%%%%%% %%% %%%%% % %%%%%%%%%%%%% %%% %%%%%%% %%%%% % %
%   % %   %     %   %%% %%% %       %   %     %%%     %   % %     %%%%%%%%%%%%% %   %%%     %%%   % %
%%%%% % %%% %%% % % %%% %%% %%% %%% %%% %%% %%%%%%%%% % %%% % %%%%%%%%%%%%%%%%% % %%%%% %%%%%%%%% % %
% %%%   %%% %%%   %   % %     % %%%   %     %%%%%%%%%   %%%     %%%     %%%%%%% % %%%%% %%%%% %%% % %
% %%% %%%%%%%%%%% % %%% % %%% %%%%%%%%%%%%%%%%%%%%%%%%%%%%% %%%%%%% % % %%%%%%% % %%%%%%%%%%% %%% %%%
%   % %%% %%% %%% %     % %%%     %%%%%%%     %%%   %%%       %%%%% % % %%%     % %%%             %%%
% %%% %%% %%% %%% %%%%%%% %%%%% %%%%%%%%%%% % %%%%% %%% %%%%%%%%%%% % % %%% %%%%% %%% %%% %%%%%%% %%%
% %%%       % %%% %%%%%%% %%%   %%%         % %%%%% %%%     %%%     % % %%%   %     %   % %%%%%%% % %
% %%%%% %%% % %%%%%%%%%%%%%%% %%%%%%%%% %%%%% %%%%% %%%%%%%%%%% %%%%% %%%%%%% % %%% %%% %%%%%%%%% % %
%   %   %%%     %%% %%% %%%   %%%%%     %     %%%%%   %%%%%%%%% %%%%% %   %%% % %%% %%%     %       %
% % % %%%%% %%%%%%% %%% %%% %%%%%%% % %%%%%%%%%%%%% %%%%%%%%%%%%%%%%% % % %%% % %%%%%%% %%% %%% %%%%%
% % % %%%%% %%%%%%% %       %       % %%%%%%%%% %%% %%%%%%%   %%% %%%   % %%% %   %%%     %   % %%%%%
%%% % %%%%%%%%%%%%% % %%% %%% %%% %%% %%%%%%%%% %%% %%%%%%% %%%%% %%% %%% %%% % %%%%% %%%%%%% %%%%%%%
%   % %   %%%         %%%     %%%   %   %                     %%%     %%%   % % %%%   %%%%%%%       %
% %%% % %%%%%%% %%%%%%%%%%% %%%%%%% %%% %%% %%% %%%%% %%% %%% %%% %%%%%%% %%% % %%%%%%%%%%%%% % %%%%%
%     % %%% %%%     %   %%% %       %%% %%% %%% %%%%% %%% %%%     %%%%%   %   %   %%%%% %%%%% %   %%%
% %%%%% %%% %%%%%%% %%% %%%%% %%%%%%%%% %%%%%%%%%%%%%%%%%%%%%%% %%%%%%% % % %%% % %%%%% %%%%%%%%% %%%
%         %   %%%%% %   %%%   %%%%%%%   %%%%%%%%%%%%%%% %%% %%% %%%%%%% % % %%% % %%%%% %%% %%%%%   %
%%%%%%%%% % %%%%%%% % % %%% %%%%%%%%% %%%%%%%%%%%%%%%%% %%% %%% %%%%%%% %%% %%%%% %%%%% %%% %%%%%%% %
%%%   %%%   %%%%%%%   %   %     %%%         %%%%%%%%%       %%%   %%%%% %%%   %%%   %   %%%     %%% %
%%%%% %%% %%%%%%%%%%% %%% %%%%% %%% %%%%% %%%%%%%%%%%%% %%% %%% %%%%%%% %%% %%%%% % %%% %%%%%%% %%% %
%     %   %%%%%%%   % %%%   %%% %%% %%%   %%%%%%%%% %%% % % %   %%%   %     %%%   %     %%%     %   %
% % %%% %%%%%%%%% % %%%%%%%%%%% %%%%%%% %%%%%%%%%%% %%% % % % %%%%%%% %%%%%%%%% % %%%%% %%% % %%% %%%
% % %%%     % %%% %     %%%%%     %%%   %%% %%% %%% %%%   %   %       %%% %%%%% % %%%%%     % %%%   %
% % %%%%%%% % %%% %%%%% %%%%%%%%% %%% %%%%% %%% %%% %%%%%%%%% % %%% %%%%% %%%%% %%%%%%% %%%%%%%%%%% %
% %       %   %   %%% %     %%%%% %       %         %%%%%%%%% %   % %%%%%       %%%     %%%%%%%     %
%%% %%% %%%%% % %%%%% %%%%% %%%%% % %%%%% %%%%%%% % %%%%%%%%% % %%% %%%%%%% % %%%%%%% %%%%%%%%% %%% %
%%% %   %%%%%   %%%     %%%       % %%%%%     %%% %     %%%   % %     %%%%% % %%%%%%% %%% %     % % %
%%%%% % %%%%%%%%%%% %%% %%%%%%%%%%%%%%%%% %%% %%% %%%%% %%%%% %%% %%% %%%%% %%%%%%%%%%%%% % % %%% % %
%     %   %%%     % %%% %%% %%%   %%% %%% %%% %%% %%%     %%%     % % %%%       %%%%%%%   % % %%%   %
%%% %%% %%%%% %%% % %%% %%% %%% %%%%% %%%%%%% %%%%%%% %%%%%%%%%%%%% % %%%%%%% % %%%%%%%%% % % %%% %%%
%%%   % %%%   %   % % %         %%%   %%%%%     %%%%% %%%%%   %%%     % %%%%% %     %%%%% % % %%% %%%
%%%%% %%%%%%% % %%% % % %%%%%%%%%%%%% %%%%%%%%% %%%%% %%%%% % %%% %%% % %%%%% %%%%% %%%%% % %%%%% %%%
% %%%     %%% % %%%   % %     %%%%%   %   %%%%%       %     %     %%%   %%%%% %%%%%       % %%%   %%%
% %%%%% %%%%% % %%%%% % % %%% %%%%% % %%% %%%%%%%%%%% % %%%%%%%%%%%%%%% %%%%% %%%%% %%%%%%% %%% %%%%%
%     % %%%%% %       %   %     %%% %         %%%%% % %   %   %%%%% %%%         %%% %%%     %   %%% %
% %%% % %%%%% %%%%%%%%% %%% %%% %%% %%%%%%% %%%%%%% % %%% % %%%%%%% %%%%%%% %%% %%%%%%% %%% %%%%%%% %
%   % % %     %%%%%%%%% %%% %%%     %%%%%%% %%% %     %   %   %%%   %%%%%   %%% %%%%%     % %%%%%   %
% % % % % %%%%%%%%%%%%%%%%% %%%%% %%%%%%%%%%%%% % %%%%% %%%%% %%% % %%%%%%%%%%%%%%%%% %%% %%%%%%% % %
% % %   %   %%% %%%%%%%%%%%   %%% %%%%%     %     %%%%%     % %   %   %%%%%%%     %   %%%     %%% % %
% % %%%%%%% %%% %%%%%%%%%%%%% %%%%%%%%% %%% % %%%%%%%%% %%% % % %%% %%%%%%%%% %%% %%% %%% %%% %%% % %
% %             %%%%%%%%%       %%%%%     %   %%%   %%% %%%   % %%% %%% %%%%% %   %%% %%% %%%     % %
%%%%% %%%%% %%%%%%%%%%%%% %%% %%%%%%% %%% %%%%%%%%% %%%%%%% %%% %%% %%% %%%%% % %%%%%%%%%%%%% %%%%% %
%%%%%   %%% %%%%% %%%       % %%%%%   %%%           %%%%%   %%% %%%   %       %         %%%   %%%   %
%%%%% %%%%% %%%%% %%%%%%%%% %%%%%%%%% %%%%% %%%%%%% %%%%% %%%%% %%%%% %%%%% %%%%%%%%%%% %%% %%%%%%%%%
%%%   %%%   %%%%%         %       %%%   %%% %%% %%%   %   %%%   %%%   %%%%%   %%%%%%%   %%%     %%%%%
%%% %%%%%%%%%%%%% %%% %%% % %%%%% %%% %%%%%%%%% %%%%% % %%%%%%% %%%%% %%%%% % %%%%%%% %%%%%%% %%%%%%%
%     %%%%%%%     %%% %%% % %%%   %%% %%% %%% %     % % %%%%%%% % %%% %     %   %%%%% %   %%% %%%%%%%
%%%%%%%%%%%%% % % %%%%%%% %%%%% %%%%% %%% %%% % %%% % %%%%%%%%% % %%% %%%%%%%%% %%%%% %%% %%% %%%%%%%
%%%%%%%%%%%   % %   %%%         %%%%% %%%     % % %   %%%       %     %%%%%%%%% %   %   %     %%%%% %
%%%%%%%%%%% %%% %%% %%% %%% %%% %%%%%%%%% % %%% % %%%%%%%%%%%%% %%% %%%%%%%%%%% %%% %%% % % %%%%%%% %
%%%%%     % %%% %%% %%% %%% %%%   %%%%%   % %   %   %%% %%%%%%% %%% %%%         %%%     % % %%% %%% %
%%%%%%% %%% %%% %%%%%%% %%%%%%% %%%%%%%%% % % %%% %%%%% %%%%%%% %%% %%% % %%%%%%%%%%% %%%%% %%% %%% %
%       %   % %   %%% %   %%%%% %%%%%%%   % %     %%%           %%%     % %%%     %%% % %%%         %
%%% %%%%% %%% % %%%%% %%% %%%%%%%%%%%%% %%%%%%% %%%%% %%%%% % %%%%%%%%% %%%%% %%%%%%% % %%%%%%% %%% %
%%%   %       % %%% %         %%%   %%% %%%%% % %%%   % %%% % %%%       %%%   %   %%% %   %%%%% %%% %
%%% % % %%% %%% %%% % %%%%%%%%%%% %%%%% %%%%% % %%% %%% %%% %%%%% %%%%%%%%% %%% % %%% %%% %%%%%%%%% %
%   %   %%% %%%   %   % %%%%%%% %         %%%   %       %%% %%%%% %%%%%%%   %%% % %   %%%     %%%   %
%%%%%%%%%%%%%%%%% % %%% %%%%%%% % %%%%% %%%%% %%%%%%%%%%%%% %%%%%%%%%%%%% %%%%% % % %%%%% %%% %%%%% %
%         %%% %%% % %%% %%%       % %%% %%% % %%%%%%%%%%%   %%%%%%%%% %%%   %   %   %     %%%   %%% %
% %%% %%% %%% %%% % %%% %%% %%%%% % %%% %%% % %%%%%%%%%%% %%%%%%%%%%% %%%%% % %%% %%%%%%% %%%%% %%% %
% %%% %%%         % %     %   %%%   %%% %%%   %%%%%%%%%     %%%%%         %   %%% %%%%%%%   %%%     %
% %%%%%%%%%%%%%%%%% %%% % %%% %%%%%%%%% %%%%% %%%%%%%%% %%% %%%%% %%%%%%% %%%%%%% %%%%%%% %%%%% %%% %
%   %%%     %%% %%%     % %%% %     %     %%%     %%%   % %       %%%%%%%   %%%   %%%     %%%   %%% %
% %%%%%%% %%%%% %%%%%%%%% %%%%% %%% % %%% %%% %%% %%% %%% %%%%%%% %%%%%%% % %%%%% %%%%%%%%%%%%% %%% %
%     %%%           %         % %%%   %%% %%% %%% %%%     %%%%%%%   %%%   % % %%% %%%%%     %%% %%% %
%%% %%%%% %%% % %%%%% %%%%%%% % %%%%%%%%%%%%% %%%%%%% %%% %%%%%%%%% %%%%%%% % %%% %%%%% % %%%%%%%%% %
%%% %%%   %%% %   %   %%%%%   %   %           % %%%%% %%%     %%%   %%%%%%% %   %   %   % %%%     % %
%%% %%% %%%%%%%%% % %%%%%%% %%% %%% %%%%%%% %%% %%%%%%%%%%% %%%%%%%%%%%%%%% %%% %%% % % % %%% %%% % %
%%% %       %%%%% % %%%%%       %%% %%%%%%% %%% %%% %%%%%%% %%%         %%% %%%   % % % %     %     %
%%% %%%%%%%%%%%%% % %%%%%%%%% %%%%% %%%%%%%%%%% %%% %%%%%%%%%%%%% %%% %%%%% %%% % % %%% %%%%%%% %%%%%
%   %         %   % %   %%%%% %%%%% %   %%%%%%%   %   %%%         %   %%% %   % %     % %%%%%%% %%%%%
% %%% %%% %%% %%% % %%% %%%%%%%%%%% % % %%%%%%%%% % % %%% %%%%%%%%% %%%%% % % %%%%%%% % %%%%%%% %%%%%
% %   %%% %   %%%       %%% %%%   % % %       %%%   %     % %%%%% %   %%%   %   %%%%% %   %%%   %   %
% % %%%%% % %%%%% %%%%%%%%% %%%%% % %%% %%%%% %%%%%%% %%% % %%%%% %%% %%%%% %%% %%%%% %%% %%% %%% % %
%   %%%   %   % % %%%%%%%%%       % %%%   %%%     %%% %%% %       %%%   %%% %   %%%%% %   %       % %
% %%%%%%% %%% % % %%%%%%%%% %%% %%% %%%%% %%%%%%% %%%%%%% %%% %%%%%%% %%%%%%% %%%%%%% % %%% %%%%%%% %
% %%% %%% %%% %   %%%   %%% %%%     %     %   %%% %       %%% %%%%%   %%%     %       % %%%   %%%%% %
% %%% %%%%%%% %%% %%%%% %%% %%%%%%%%% %%%%% %%%%% % % %%%%%%% %%%%% %%%%% % %%% %%%%%%% %%%%% %%%%%%%
% %%%   %%%   %%% %%%%% %%%           %     %%%%%   % %%%%%   %%%%%   %   %!%   %       % %%% %%%%%%%
%%%%% %%%%% %%%%%%%%%%% %%%%%%%%%%%%%%%%% %%%%%%% %%% %%%%% % %%%%%%% %%%%% %%% % %%% %%% %%% %%%%%%%
%%%         %%%             %%%%%%% %%%%%   %%%   %%% %%%   % %%%%%       % %%%   %   %%%   %   %%%%%
%%% %%% %%% %%% %%% %%%%%%% %%%%%%% %%%%%%% %%% %%%%%%%%%%% % %%%%%%%%%%% % %%%%% %%%%%%% %%%%% %%%%%
% % %   %     % %%% %%%%%%%       %   %%%%%     %%%%%%% %%% %     %%%%%%%   %   % %%%%%   %%%%% %%%%%
% % % %%%%%%% % %%%%%%%%%%% %%%%% % %%%%%%% %%%%%%%%%%% %%% %%% %%%%%%%%% %%% % % %%%%% %%%%%%% %%%%%
%   %   %%%%% %   %%%%% %   %       %%%       %%% %%%%%   %   % %   %%%%% %%% %     %%% %         %%%
% %%%%% %%%%%%% %%%%%%% % %%% %%%%% %%% %%%%%%%%% %%%%% %%%%% % % % %%%%% %%%%% %%% %%% % %%%%%%%%%%%
% %%%%% %       %%%     %   % %%%%% %%%   % %%%   %%% %   %   %   %       %%%%% %%% %%%     %%% %%%%%
% %%%%% % %%%%% %%% %%% %%% %%%%%%%%%%%%% % %%% %%%%% % % % %%%%%%% %%% %%%%%%%%%%%%%%% %%% %%% %%%%%
%   %%%   %%%%%     %%% %%%                     %%%%%   %   %%%%%%% %%%     %%%%%%%%%   %%%       %%%
%%%%%%%%%%%%%%%%%%%%%%%%%%%%%%%%%%%%%%%%%%%%%%%%%%%%%%%%%%%%%%%%%%%%%%%%%%%%%%%%%%%%%%%%%%%%%%%%%%%%%
